circuito_id,mesa_id,agrupacion_nombre,cargo_nombre,votos_cantidad_generales,votos_cantidad_paso,diferencia_absoluta,z_score_diferencia
00060,6,JUNTOS POR EL CAMBIO,DIPUTADO NACIONAL,81,0,81,3.8393509291640724
00060,6,JUNTOS POR EL CAMBIO,SENADOR NACIONAL,79,0,79,3.7231666248570447
00060,6,UNION POR LA PATRIA,DIPUTADO NACIONAL,80,0,80,3.781258777010559
00060,6,UNION POR LA PATRIA,SENADOR NACIONAL,82,0,82,3.897443081317586
00060,49,JUNTOS POR EL CAMBIO,PRESIDENTE Y VICE,53,120,67,3.0260607990148807
00060,101,LA LIBERTAD AVANZA,DIPUTADO NACIONAL,79,1,78,3.665074472703531
00060,101,LA LIBERTAD AVANZA,PRESIDENTE Y VICE,90,1,89,4.304088146392182
00060,101,LA LIBERTAD AVANZA,SENADOR NACIONAL,80,1,79,3.7231666248570447
00060,115,LA LIBERTAD AVANZA,DIPUTADO NACIONAL,87,0,87,4.187903842085155
00060,115,LA LIBERTAD AVANZA,PRESIDENTE Y VICE,101,0,101,5.001193972234346
00060,115,LA LIBERTAD AVANZA,SENADOR NACIONAL,87,0,87,4.187903842085155
00060,115,UNION POR LA PATRIA,DIPUTADO NACIONAL,73,0,73,3.3746137119359627
00060,115,UNION POR LA PATRIA,PRESIDENTE Y VICE,78,0,78,3.665074472703531
00060,115,UNION POR LA PATRIA,SENADOR NACIONAL,73,0,73,3.3746137119359627
00062,152,JUNTOS POR EL CAMBIO,DIPUTADO NACIONAL,0,71,71,3.2584294076289355
00062,152,JUNTOS POR EL CAMBIO,PRESIDENTE Y VICE,0,78,78,3.665074472703531
00062,152,JUNTOS POR EL CAMBIO,SENADOR NACIONAL,0,69,69,3.142245103321908
00062,152,LA LIBERTAD AVANZA,DIPUTADO NACIONAL,0,83,83,3.9555352334710996
00062,152,LA LIBERTAD AVANZA,PRESIDENTE Y VICE,0,83,83,3.9555352334710996
00062,152,LA LIBERTAD AVANZA,SENADOR NACIONAL,0,83,83,3.9555352334710996
00067,169,JUNTOS POR EL CAMBIO,DIPUTADO NACIONAL,0,114,114,5.756391950230024
00067,169,JUNTOS POR EL CAMBIO,PRESIDENTE Y VICE,0,105,105,5.233562580848401
00067,169,JUNTOS POR EL CAMBIO,SENADOR NACIONAL,0,114,114,5.756391950230024
00067,170,HACEMOS POR NUESTRO PAIS,PRESIDENTE Y VICE,80,6,74,3.4327058640894763
00105,10,UNION POR LA PATRIA,DIPUTADO NACIONAL,120,50,70,3.2003372554754215
00105,10,UNION POR LA PATRIA,SENADOR NACIONAL,120,51,69,3.142245103321908
00105,35,LA LIBERTAD AVANZA,DIPUTADO NACIONAL,67,0,67,3.0260607990148807
00105,35,LA LIBERTAD AVANZA,PRESIDENTE Y VICE,77,0,77,3.6069823205500176
00105,35,LA LIBERTAD AVANZA,SENADOR NACIONAL,68,0,68,3.0841529511683943
00105,35,UNION POR LA PATRIA,DIPUTADO NACIONAL,109,0,109,5.465931189462456
00105,35,UNION POR LA PATRIA,PRESIDENTE Y VICE,117,0,117,5.9306684066905655
00105,35,UNION POR LA PATRIA,SENADOR NACIONAL,111,0,111,5.582115493769483
00105,37,UNION POR LA PATRIA,DIPUTADO NACIONAL,0,105,105,5.233562580848401
00105,37,UNION POR LA PATRIA,PRESIDENTE Y VICE,0,101,101,5.001193972234346
00105,37,UNION POR LA PATRIA,SENADOR NACIONAL,0,106,106,5.291654733001915
00105,51,JUNTOS POR EL CAMBIO,DIPUTADO NACIONAL,0,67,67,3.0260607990148807
00105,51,JUNTOS POR EL CAMBIO,PRESIDENTE Y VICE,0,70,70,3.2003372554754215
00105,51,JUNTOS POR EL CAMBIO,SENADOR NACIONAL,0,68,68,3.0841529511683943
00105,51,UNION POR LA PATRIA,PRESIDENTE Y VICE,0,88,88,4.245995994238668
00107,72,LA LIBERTAD AVANZA,PRESIDENTE Y VICE,8,77,69,3.142245103321908
00107,84,UNION POR LA PATRIA,DIPUTADO NACIONAL,68,0,68,3.0841529511683943
00107,84,UNION POR LA PATRIA,PRESIDENTE Y VICE,68,0,68,3.0841529511683943
00107,84,UNION POR LA PATRIA,SENADOR NACIONAL,68,0,68,3.0841529511683943
00110,87,JUNTOS POR EL CAMBIO,DIPUTADO NACIONAL,68,0,68,3.0841529511683943
00110,87,JUNTOS POR EL CAMBIO,PRESIDENTE Y VICE,72,0,72,3.316521559782449
00110,87,JUNTOS POR EL CAMBIO,SENADOR NACIONAL,68,0,68,3.0841529511683943
00110,87,LA LIBERTAD AVANZA,DIPUTADO NACIONAL,69,0,69,3.142245103321908
00110,87,LA LIBERTAD AVANZA,PRESIDENTE Y VICE,75,0,75,3.49079801624299
00110,87,LA LIBERTAD AVANZA,SENADOR NACIONAL,69,0,69,3.142245103321908
00110,87,UNION POR LA PATRIA,DIPUTADO NACIONAL,129,0,129,6.62777423253273
00110,87,UNION POR LA PATRIA,PRESIDENTE Y VICE,132,0,132,6.802050688993271
00110,87,UNION POR LA PATRIA,SENADOR NACIONAL,128,0,128,6.569682080379216
00117,14,LA LIBERTAD AVANZA,PRESIDENTE Y VICE,83,14,69,3.142245103321908
00117,33,JUNTOS POR EL CAMBIO,SENADOR NACIONAL,17,116,99,4.885009667927319
00117,34,LA LIBERTAD AVANZA,PRESIDENTE Y VICE,101,33,68,3.0841529511683943
00117,47,JUNTOS POR EL CAMBIO,DIPUTADO NACIONAL,0,108,108,5.407839037308942
00117,47,JUNTOS POR EL CAMBIO,PRESIDENTE Y VICE,0,102,102,5.05928612438786
00117,47,JUNTOS POR EL CAMBIO,SENADOR NACIONAL,0,109,109,5.465931189462456
00117,47,LA LIBERTAD AVANZA,PRESIDENTE Y VICE,0,72,72,3.316521559782449
00117,47,UNION POR LA PATRIA,DIPUTADO NACIONAL,0,86,86,4.129811689931641
00117,47,UNION POR LA PATRIA,PRESIDENTE Y VICE,0,82,82,3.897443081317586
00117,47,UNION POR LA PATRIA,SENADOR NACIONAL,0,86,86,4.129811689931641
00118,75,JUNTOS POR EL CAMBIO,DIPUTADO NACIONAL,0,88,88,4.245995994238668
00118,75,JUNTOS POR EL CAMBIO,PRESIDENTE Y VICE,0,90,90,4.362180298545695
00118,75,JUNTOS POR EL CAMBIO,SENADOR NACIONAL,0,89,89,4.304088146392182
00118,75,UNION POR LA PATRIA,DIPUTADO NACIONAL,0,74,74,3.4327058640894763
00118,75,UNION POR LA PATRIA,PRESIDENTE Y VICE,0,78,78,3.665074472703531
00118,75,UNION POR LA PATRIA,SENADOR NACIONAL,0,76,76,3.548890168396504
00125,15,JUNTOS POR EL CAMBIO,DIPUTADO NACIONAL,84,0,84,4.013627385624614
00125,15,JUNTOS POR EL CAMBIO,PRESIDENTE Y VICE,76,0,76,3.548890168396504
00125,15,JUNTOS POR EL CAMBIO,SENADOR NACIONAL,83,0,83,3.9555352334710996
00125,15,LA LIBERTAD AVANZA,DIPUTADO NACIONAL,79,0,79,3.7231666248570447
00125,15,LA LIBERTAD AVANZA,PRESIDENTE Y VICE,99,0,99,4.885009667927319
00125,15,LA LIBERTAD AVANZA,SENADOR NACIONAL,80,0,80,3.781258777010559
00125,15,UNION POR LA PATRIA,DIPUTADO NACIONAL,73,0,73,3.3746137119359627
00125,15,UNION POR LA PATRIA,PRESIDENTE Y VICE,81,0,81,3.8393509291640724
00125,15,UNION POR LA PATRIA,SENADOR NACIONAL,73,0,73,3.3746137119359627
00125,47,JUNTOS POR EL CAMBIO,DIPUTADO NACIONAL,97,0,97,4.768825363620292
00125,47,JUNTOS POR EL CAMBIO,PRESIDENTE Y VICE,93,0,93,4.5364567550062365
00125,47,JUNTOS POR EL CAMBIO,SENADOR NACIONAL,98,0,98,4.826917515773805
00125,47,LA LIBERTAD AVANZA,PRESIDENTE Y VICE,73,0,73,3.3746137119359627
00125,47,UNION POR LA PATRIA,DIPUTADO NACIONAL,92,0,92,4.478364602852723
00125,47,UNION POR LA PATRIA,PRESIDENTE Y VICE,96,0,96,4.710733211466778
00125,47,UNION POR LA PATRIA,SENADOR NACIONAL,92,0,92,4.478364602852723
00125,60,JUNTOS POR EL CAMBIO,DIPUTADO NACIONAL,103,0,103,5.117378276541373
00125,60,JUNTOS POR EL CAMBIO,PRESIDENTE Y VICE,98,0,98,4.826917515773805
00125,60,JUNTOS POR EL CAMBIO,SENADOR NACIONAL,103,0,103,5.117378276541373
00125,60,LA LIBERTAD AVANZA,DIPUTADO NACIONAL,74,0,74,3.4327058640894763
00125,60,LA LIBERTAD AVANZA,PRESIDENTE Y VICE,89,0,89,4.304088146392182
00125,60,LA LIBERTAD AVANZA,SENADOR NACIONAL,74,0,74,3.4327058640894763
00175,20,UNION POR LA PATRIA,DIPUTADO NACIONAL,103,0,103,5.117378276541373
00230,7,JUNTOS POR EL CAMBIO,DIPUTADO NACIONAL,91,0,91,4.420272450699209
00230,7,JUNTOS POR EL CAMBIO,PRESIDENTE Y VICE,87,0,87,4.187903842085155
00230,7,JUNTOS POR EL CAMBIO,SENADOR NACIONAL,90,0,90,4.362180298545695
00230,7,LA LIBERTAD AVANZA,PRESIDENTE Y VICE,72,0,72,3.316521559782449
00230,7,UNION POR LA PATRIA,DIPUTADO NACIONAL,93,0,93,4.5364567550062365
00230,7,UNION POR LA PATRIA,PRESIDENTE Y VICE,95,0,95,4.652641059313264
00230,7,UNION POR LA PATRIA,SENADOR NACIONAL,93,0,93,4.5364567550062365
00230,13,UNION POR LA PATRIA,PRESIDENTE Y VICE,13,92,79,3.7231666248570447
00230,31,UNION POR LA PATRIA,DIPUTADO NACIONAL,94,5,89,4.304088146392182
00230,31,UNION POR LA PATRIA,PRESIDENTE Y VICE,101,5,96,4.710733211466778
00230,31,UNION POR LA PATRIA,SENADOR NACIONAL,94,5,89,4.304088146392182
00230,40,JUNTOS POR EL CAMBIO,DIPUTADO NACIONAL,73,0,73,3.3746137119359627
00230,40,JUNTOS POR EL CAMBIO,SENADOR NACIONAL,76,0,76,3.548890168396504
00230,40,UNION POR LA PATRIA,DIPUTADO NACIONAL,104,0,104,5.175470428694887
00230,40,UNION POR LA PATRIA,PRESIDENTE Y VICE,109,0,109,5.465931189462456
00230,40,UNION POR LA PATRIA,SENADOR NACIONAL,104,0,104,5.175470428694887
00292,6,UNION POR LA PATRIA,DIPUTADO NACIONAL,85,13,72,3.316521559782449
00292,15,JUNTOS POR EL CAMBIO,DIPUTADO NACIONAL,0,82,82,3.897443081317586
00292,15,JUNTOS POR EL CAMBIO,PRESIDENTE Y VICE,0,86,86,4.129811689931641
00292,15,JUNTOS POR EL CAMBIO,SENADOR NACIONAL,0,83,83,3.9555352334710996
00292,15,UNION POR LA PATRIA,DIPUTADO NACIONAL,0,84,84,4.013627385624614
00292,15,UNION POR LA PATRIA,PRESIDENTE Y VICE,0,79,79,3.7231666248570447
00292,15,UNION POR LA PATRIA,SENADOR NACIONAL,0,85,85,4.071719537778127
00292,20,JUNTOS POR EL CAMBIO,DIPUTADO NACIONAL,92,0,92,4.478364602852723
00292,20,JUNTOS POR EL CAMBIO,PRESIDENTE Y VICE,84,0,84,4.013627385624614
00292,20,JUNTOS POR EL CAMBIO,SENADOR NACIONAL,92,0,92,4.478364602852723
00292,20,LA LIBERTAD AVANZA,DIPUTADO NACIONAL,68,0,68,3.0841529511683943
00292,20,LA LIBERTAD AVANZA,PRESIDENTE Y VICE,85,0,85,4.071719537778127
00292,20,LA LIBERTAD AVANZA,SENADOR NACIONAL,67,0,67,3.0260607990148807
00292,20,UNION POR LA PATRIA,DIPUTADO NACIONAL,84,0,84,4.013627385624614
00292,20,UNION POR LA PATRIA,PRESIDENTE Y VICE,89,0,89,4.304088146392182
00292,20,UNION POR LA PATRIA,SENADOR NACIONAL,85,0,85,4.071719537778127
00293,31,UNION POR LA PATRIA,DIPUTADO NACIONAL,106,0,106,5.291654733001915
00293,31,UNION POR LA PATRIA,PRESIDENTE Y VICE,111,0,111,5.582115493769483
00293,31,UNION POR LA PATRIA,SENADOR NACIONAL,106,0,106,5.291654733001915
00293,34,UNION POR LA PATRIA,DIPUTADO NACIONAL,103,0,103,5.117378276541373
00293,34,UNION POR LA PATRIA,PRESIDENTE Y VICE,112,27,85,4.071719537778127
00293,34,UNION POR LA PATRIA,SENADOR NACIONAL,105,0,105,5.233562580848401
00293,45,JUNTOS POR EL CAMBIO,PRESIDENTE Y VICE,71,0,71,3.2584294076289355
00293,45,JUNTOS POR EL CAMBIO,SENADOR NACIONAL,67,0,67,3.0260607990148807
00293,45,LA LIBERTAD AVANZA,DIPUTADO NACIONAL,98,0,98,4.826917515773805
00293,45,LA LIBERTAD AVANZA,PRESIDENTE Y VICE,114,0,114,5.756391950230024
00293,45,LA LIBERTAD AVANZA,SENADOR NACIONAL,98,0,98,4.826917515773805
00310,11,JUNTOS POR EL CAMBIO,DIPUTADO NACIONAL,91,0,91,4.420272450699209
00310,11,JUNTOS POR EL CAMBIO,PRESIDENTE Y VICE,94,0,94,4.5945489071597505
00310,11,JUNTOS POR EL CAMBIO,SENADOR NACIONAL,91,0,91,4.420272450699209
00310,11,LA LIBERTAD AVANZA,PRESIDENTE Y VICE,83,0,83,3.9555352334710996
00310,11,UNION POR LA PATRIA,DIPUTADO NACIONAL,94,0,94,4.5945489071597505
00310,11,UNION POR LA PATRIA,PRESIDENTE Y VICE,95,0,95,4.652641059313264
00310,11,UNION POR LA PATRIA,SENADOR NACIONAL,94,0,94,4.5945489071597505
00310,23,JUNTOS POR EL CAMBIO,DIPUTADO NACIONAL,0,105,105,5.233562580848401
00310,23,JUNTOS POR EL CAMBIO,PRESIDENTE Y VICE,0,105,105,5.233562580848401
00310,23,JUNTOS POR EL CAMBIO,SENADOR NACIONAL,0,105,105,5.233562580848401
00310,24,JUNTOS POR EL CAMBIO,DIPUTADO NACIONAL,95,0,95,4.652641059313264
00310,24,JUNTOS POR EL CAMBIO,PRESIDENTE Y VICE,102,0,102,5.05928612438786
00310,24,JUNTOS POR EL CAMBIO,SENADOR NACIONAL,93,0,93,4.5364567550062365
00310,24,LA LIBERTAD AVANZA,PRESIDENTE Y VICE,83,0,83,3.9555352334710996
00310,24,UNION POR LA PATRIA,DIPUTADO NACIONAL,78,0,78,3.665074472703531
00310,24,UNION POR LA PATRIA,PRESIDENTE Y VICE,84,0,84,4.013627385624614
00310,24,UNION POR LA PATRIA,SENADOR NACIONAL,78,0,78,3.665074472703531
00463,17,JUNTOS POR EL CAMBIO,DIPUTADO NACIONAL,127,0,127,6.511589928225702
00463,17,JUNTOS POR EL CAMBIO,PRESIDENTE Y VICE,122,0,122,6.221129167458134
00463,17,JUNTOS POR EL CAMBIO,SENADOR NACIONAL,127,0,127,6.511589928225702
00463,17,UNION POR LA PATRIA,DIPUTADO NACIONAL,79,0,79,3.7231666248570447
00463,17,UNION POR LA PATRIA,PRESIDENTE Y VICE,81,0,81,3.8393509291640724
00463,17,UNION POR LA PATRIA,SENADOR NACIONAL,81,0,81,3.8393509291640724
00463,19,JUNTOS POR EL CAMBIO,DIPUTADO NACIONAL,112,0,112,5.640207645922997
00463,19,JUNTOS POR EL CAMBIO,PRESIDENTE Y VICE,107,0,107,5.349746885155429
00463,19,JUNTOS POR EL CAMBIO,SENADOR NACIONAL,114,0,114,5.756391950230024
00463,19,UNION POR LA PATRIA,PRESIDENTE Y VICE,73,0,73,3.3746137119359627
00468,48,JUNTOS POR EL CAMBIO,DIPUTADO NACIONAL,106,0,106,5.291654733001915
00468,48,JUNTOS POR EL CAMBIO,PRESIDENTE Y VICE,97,0,97,4.768825363620292
00468,48,JUNTOS POR EL CAMBIO,SENADOR NACIONAL,106,0,106,5.291654733001915
00468,48,UNION POR LA PATRIA,DIPUTADO NACIONAL,113,0,113,5.69829979807651
00468,48,UNION POR LA PATRIA,PRESIDENTE Y VICE,122,0,122,6.221129167458134
00468,48,UNION POR LA PATRIA,SENADOR NACIONAL,116,0,116,5.8725762545370515
00469,52,JUNTOS POR EL CAMBIO,DIPUTADO NACIONAL,0,90,90,4.362180298545695
00469,52,JUNTOS POR EL CAMBIO,PRESIDENTE Y VICE,0,88,88,4.245995994238668
00469,52,JUNTOS POR EL CAMBIO,SENADOR NACIONAL,0,92,92,4.478364602852723
00469,52,UNION POR LA PATRIA,DIPUTADO NACIONAL,0,98,98,4.826917515773805
00469,52,UNION POR LA PATRIA,PRESIDENTE Y VICE,0,98,98,4.826917515773805
00469,52,UNION POR LA PATRIA,SENADOR NACIONAL,0,99,99,4.885009667927319
00473,74,JUNTOS POR EL CAMBIO,DIPUTADO NACIONAL,97,0,97,4.768825363620292
00473,74,JUNTOS POR EL CAMBIO,PRESIDENTE Y VICE,90,0,90,4.362180298545695
00473,74,JUNTOS POR EL CAMBIO,SENADOR NACIONAL,98,0,98,4.826917515773805
00473,74,UNION POR LA PATRIA,DIPUTADO NACIONAL,113,0,113,5.69829979807651
00473,74,UNION POR LA PATRIA,PRESIDENTE Y VICE,120,0,120,6.104944863151107
00473,74,UNION POR LA PATRIA,SENADOR NACIONAL,114,0,114,5.756391950230024
00473,76,JUNTOS POR EL CAMBIO,DIPUTADO NACIONAL,0,121,121,6.16303701530462
00473,76,JUNTOS POR EL CAMBIO,PRESIDENTE Y VICE,0,116,116,5.8725762545370515
00473,76,JUNTOS POR EL CAMBIO,SENADOR NACIONAL,0,118,118,5.9887605588440795
00473,76,UNION POR LA PATRIA,PRESIDENTE Y VICE,0,68,68,3.0841529511683943
00473,76,UNION POR LA PATRIA,SENADOR NACIONAL,0,68,68,3.0841529511683943
00473,78,JUNTOS POR EL CAMBIO,DIPUTADO NACIONAL,0,130,130,6.685866384686244
00473,78,JUNTOS POR EL CAMBIO,PRESIDENTE Y VICE,0,128,128,6.569682080379216
00473,78,JUNTOS POR EL CAMBIO,SENADOR NACIONAL,0,132,132,6.802050688993271
00473,78,UNION POR LA PATRIA,DIPUTADO NACIONAL,0,68,68,3.0841529511683943
00473,78,UNION POR LA PATRIA,PRESIDENTE Y VICE,0,68,68,3.0841529511683943
00473,78,UNION POR LA PATRIA,SENADOR NACIONAL,0,69,69,3.142245103321908
00475,103,JUNTOS POR EL CAMBIO,DIPUTADO NACIONAL,112,0,112,5.640207645922997
00475,103,JUNTOS POR EL CAMBIO,PRESIDENTE Y VICE,107,0,107,5.349746885155429
00475,103,JUNTOS POR EL CAMBIO,SENADOR NACIONAL,110,0,110,5.52402334161597
00475,103,UNION POR LA PATRIA,DIPUTADO NACIONAL,73,0,73,3.3746137119359627
00475,103,UNION POR LA PATRIA,PRESIDENTE Y VICE,82,0,82,3.897443081317586
00475,103,UNION POR LA PATRIA,SENADOR NACIONAL,77,0,77,3.6069823205500176
00475,116,LA LIBERTAD AVANZA,PRESIDENTE Y VICE,45,135,90,4.362180298545695
00475,118,JUNTOS POR EL CAMBIO,DIPUTADO NACIONAL,0,147,147,7.673432971295976
00475,118,JUNTOS POR EL CAMBIO,PRESIDENTE Y VICE,0,149,149,7.789617275603003
00475,118,JUNTOS POR EL CAMBIO,SENADOR NACIONAL,0,148,148,7.73152512344949
00475,135,UNION POR LA PATRIA,DIPUTADO NACIONAL,0,68,68,3.0841529511683943
00475,135,UNION POR LA PATRIA,SENADOR NACIONAL,0,71,71,3.2584294076289355
00480,170,JUNTOS POR EL CAMBIO,DIPUTADO NACIONAL,117,0,117,5.9306684066905655
00480,170,JUNTOS POR EL CAMBIO,PRESIDENTE Y VICE,113,0,113,5.69829979807651
00480,170,JUNTOS POR EL CAMBIO,SENADOR NACIONAL,118,0,118,5.9887605588440795
00480,170,UNION POR LA PATRIA,DIPUTADO NACIONAL,84,0,84,4.013627385624614
00480,170,UNION POR LA PATRIA,PRESIDENTE Y VICE,99,0,99,4.885009667927319
00480,170,UNION POR LA PATRIA,SENADOR NACIONAL,88,0,88,4.245995994238668
00482,190,JUNTOS POR EL CAMBIO,DIPUTADO NACIONAL,0,114,114,5.756391950230024
00482,190,JUNTOS POR EL CAMBIO,PRESIDENTE Y VICE,0,114,114,5.756391950230024
00482,190,JUNTOS POR EL CAMBIO,SENADOR NACIONAL,0,114,114,5.756391950230024
00482,190,LA LIBERTAD AVANZA,PRESIDENTE Y VICE,0,82,82,3.897443081317586
00482,190,UNION POR LA PATRIA,DIPUTADO NACIONAL,0,76,76,3.548890168396504
00482,190,UNION POR LA PATRIA,PRESIDENTE Y VICE,0,73,73,3.3746137119359627
00482,190,UNION POR LA PATRIA,SENADOR NACIONAL,0,76,76,3.548890168396504
00484,202,JUNTOS POR EL CAMBIO,DIPUTADO NACIONAL,0,119,119,6.046852710997593
00484,202,JUNTOS POR EL CAMBIO,PRESIDENTE Y VICE,0,114,114,5.756391950230024
00484,202,JUNTOS POR EL CAMBIO,SENADOR NACIONAL,0,120,120,6.104944863151107
00484,202,UNION POR LA PATRIA,PRESIDENTE Y VICE,0,67,67,3.0260607990148807
00486,221,JUNTOS POR EL CAMBIO,DIPUTADO NACIONAL,0,97,97,4.768825363620292
00486,221,JUNTOS POR EL CAMBIO,PRESIDENTE Y VICE,0,101,101,5.001193972234346
00486,221,JUNTOS POR EL CAMBIO,SENADOR NACIONAL,0,95,95,4.652641059313264
00486,221,UNION POR LA PATRIA,DIPUTADO NACIONAL,0,87,87,4.187903842085155
00486,221,UNION POR LA PATRIA,PRESIDENTE Y VICE,0,86,86,4.129811689931641
00486,221,UNION POR LA PATRIA,SENADOR NACIONAL,0,87,87,4.187903842085155
00495,280,JUNTOS POR EL CAMBIO,DIPUTADO NACIONAL,0,111,111,5.582115493769483
00495,280,JUNTOS POR EL CAMBIO,PRESIDENTE Y VICE,0,107,107,5.349746885155429
00495,280,JUNTOS POR EL CAMBIO,SENADOR NACIONAL,0,110,110,5.52402334161597
00495,280,UNION POR LA PATRIA,DIPUTADO NACIONAL,0,67,67,3.0260607990148807
00495,280,UNION POR LA PATRIA,PRESIDENTE Y VICE,0,67,67,3.0260607990148807
00495,280,UNION POR LA PATRIA,SENADOR NACIONAL,0,67,67,3.0260607990148807
00495,281,JUNTOS POR EL CAMBIO,DIPUTADO NACIONAL,117,0,117,5.9306684066905655
00495,281,JUNTOS POR EL CAMBIO,PRESIDENTE Y VICE,116,0,116,5.8725762545370515
00495,281,JUNTOS POR EL CAMBIO,SENADOR NACIONAL,116,0,116,5.8725762545370515
00495,281,UNION POR LA PATRIA,DIPUTADO NACIONAL,90,0,90,4.362180298545695
00495,281,UNION POR LA PATRIA,PRESIDENTE Y VICE,102,0,102,5.05928612438786
00495,281,UNION POR LA PATRIA,SENADOR NACIONAL,93,0,93,4.5364567550062365
00495,289,JUNTOS POR EL CAMBIO,DIPUTADO NACIONAL,0,107,107,5.349746885155429
00495,289,JUNTOS POR EL CAMBIO,PRESIDENTE Y VICE,0,114,114,5.756391950230024
00495,289,JUNTOS POR EL CAMBIO,SENADOR NACIONAL,0,109,109,5.465931189462456
00495,289,UNION POR LA PATRIA,DIPUTADO NACIONAL,0,87,87,4.187903842085155
00495,289,UNION POR LA PATRIA,PRESIDENTE Y VICE,0,84,84,4.013627385624614
00495,289,UNION POR LA PATRIA,SENADOR NACIONAL,0,88,88,4.245995994238668
00495,302,JUNTOS POR EL CAMBIO,DIPUTADO NACIONAL,0,117,117,5.9306684066905655
00495,302,JUNTOS POR EL CAMBIO,PRESIDENTE Y VICE,0,112,112,5.640207645922997
00495,302,JUNTOS POR EL CAMBIO,SENADOR NACIONAL,0,117,117,5.9306684066905655
00495,302,UNION POR LA PATRIA,DIPUTADO NACIONAL,0,88,88,4.245995994238668
00495,302,UNION POR LA PATRIA,PRESIDENTE Y VICE,0,97,97,4.768825363620292
00495,302,UNION POR LA PATRIA,SENADOR NACIONAL,0,88,88,4.245995994238668
00496,344,JUNTOS POR EL CAMBIO,DIPUTADO NACIONAL,75,0,75,3.49079801624299
00496,344,JUNTOS POR EL CAMBIO,PRESIDENTE Y VICE,72,0,72,3.316521559782449
00496,344,JUNTOS POR EL CAMBIO,SENADOR NACIONAL,73,0,73,3.3746137119359627
00496,344,UNION POR LA PATRIA,DIPUTADO NACIONAL,99,0,99,4.885009667927319
00496,344,UNION POR LA PATRIA,PRESIDENTE Y VICE,106,0,106,5.291654733001915
00496,344,UNION POR LA PATRIA,SENADOR NACIONAL,101,0,101,5.001193972234346
00496,346,JUNTOS POR EL CAMBIO,DIPUTADO NACIONAL,0,77,77,3.6069823205500176
00496,346,JUNTOS POR EL CAMBIO,SENADOR NACIONAL,0,77,77,3.6069823205500176
00496,346,UNION POR LA PATRIA,DIPUTADO NACIONAL,0,68,68,3.0841529511683943
00496,346,UNION POR LA PATRIA,SENADOR NACIONAL,0,69,69,3.142245103321908
00496,348,JUNTOS POR EL CAMBIO,DIPUTADO NACIONAL,0,82,82,3.897443081317586
00496,348,JUNTOS POR EL CAMBIO,PRESIDENTE Y VICE,0,88,88,4.245995994238668
00496,348,JUNTOS POR EL CAMBIO,SENADOR NACIONAL,0,83,83,3.9555352334710996
00496,348,UNION POR LA PATRIA,DIPUTADO NACIONAL,0,70,70,3.2003372554754215
00496,348,UNION POR LA PATRIA,PRESIDENTE Y VICE,0,71,71,3.2584294076289355
00496,348,UNION POR LA PATRIA,SENADOR NACIONAL,0,72,72,3.316521559782449
00496,371,JUNTOS POR EL CAMBIO,DIPUTADO NACIONAL,96,0,96,4.710733211466778
00496,371,JUNTOS POR EL CAMBIO,PRESIDENTE Y VICE,95,0,95,4.652641059313264
00496,371,JUNTOS POR EL CAMBIO,SENADOR NACIONAL,99,0,99,4.885009667927319
00496,371,LA LIBERTAD AVANZA,PRESIDENTE Y VICE,69,0,69,3.142245103321908
00496,371,UNION POR LA PATRIA,DIPUTADO NACIONAL,87,0,87,4.187903842085155
00496,371,UNION POR LA PATRIA,PRESIDENTE Y VICE,94,0,94,4.5945489071597505
00496,371,UNION POR LA PATRIA,SENADOR NACIONAL,89,0,89,4.304088146392182
00496,377,UNION POR LA PATRIA,PRESIDENTE Y VICE,23,93,70,3.2003372554754215
00496,378,UNION POR LA PATRIA,SENADOR NACIONAL,25,97,72,3.316521559782449
00496,390,UNION POR LA PATRIA,PRESIDENTE Y VICE,112,40,72,3.316521559782449
00497,610,JUNTOS POR EL CAMBIO,DIPUTADO NACIONAL,104,0,104,5.175470428694887
00497,610,JUNTOS POR EL CAMBIO,PRESIDENTE Y VICE,103,0,103,5.117378276541373
00497,610,JUNTOS POR EL CAMBIO,SENADOR NACIONAL,104,0,104,5.175470428694887
00497,610,UNION POR LA PATRIA,DIPUTADO NACIONAL,81,0,81,3.8393509291640724
00497,610,UNION POR LA PATRIA,PRESIDENTE Y VICE,83,0,83,3.9555352334710996
00497,610,UNION POR LA PATRIA,SENADOR NACIONAL,81,0,81,3.8393509291640724
00497,612,UNION POR LA PATRIA,SENADOR NACIONAL,99,29,70,3.2003372554754215
00501,781,JUNTOS POR EL CAMBIO,DIPUTADO NACIONAL,0,106,106,5.291654733001915
00501,781,JUNTOS POR EL CAMBIO,SENADOR NACIONAL,0,105,105,5.233562580848401
00501,786,JUNTOS POR EL CAMBIO,DIPUTADO NACIONAL,0,103,103,5.117378276541373
00501,786,JUNTOS POR EL CAMBIO,PRESIDENTE Y VICE,0,100,100,4.943101820080833
00501,786,JUNTOS POR EL CAMBIO,SENADOR NACIONAL,0,103,103,5.117378276541373
00501,789,JUNTOS POR EL CAMBIO,DIPUTADO NACIONAL,95,0,95,4.652641059313264
00501,789,JUNTOS POR EL CAMBIO,PRESIDENTE Y VICE,87,0,87,4.187903842085155
00501,789,JUNTOS POR EL CAMBIO,SENADOR NACIONAL,93,0,93,4.5364567550062365
00501,789,UNION POR LA PATRIA,DIPUTADO NACIONAL,90,0,90,4.362180298545695
00501,789,UNION POR LA PATRIA,PRESIDENTE Y VICE,108,0,108,5.407839037308942
00501,789,UNION POR LA PATRIA,SENADOR NACIONAL,94,0,94,4.5945489071597505
00501,795,JUNTOS POR EL CAMBIO,DIPUTADO NACIONAL,104,0,104,5.175470428694887
00501,795,JUNTOS POR EL CAMBIO,PRESIDENTE Y VICE,97,0,97,4.768825363620292
00501,795,JUNTOS POR EL CAMBIO,SENADOR NACIONAL,102,0,102,5.05928612438786
00501,795,UNION POR LA PATRIA,DIPUTADO NACIONAL,86,0,86,4.129811689931641
00501,795,UNION POR LA PATRIA,PRESIDENTE Y VICE,93,0,93,4.5364567550062365
00501,795,UNION POR LA PATRIA,SENADOR NACIONAL,85,0,85,4.071719537778127
00501,822,JUNTOS POR EL CAMBIO,DIPUTADO NACIONAL,0,83,83,3.9555352334710996
00501,822,JUNTOS POR EL CAMBIO,SENADOR NACIONAL,0,85,85,4.071719537778127
00501,822,UNION POR LA PATRIA,DIPUTADO NACIONAL,0,70,70,3.2003372554754215
00501,822,UNION POR LA PATRIA,SENADOR NACIONAL,0,70,70,3.2003372554754215
00501,842,UNION POR LA PATRIA,DIPUTADO NACIONAL,0,84,84,4.013627385624614
00501,842,UNION POR LA PATRIA,SENADOR NACIONAL,0,85,85,4.071719537778127
00501,844,JUNTOS POR EL CAMBIO,DIPUTADO NACIONAL,111,0,111,5.582115493769483
00501,844,JUNTOS POR EL CAMBIO,PRESIDENTE Y VICE,104,0,104,5.175470428694887
00501,844,JUNTOS POR EL CAMBIO,SENADOR NACIONAL,109,0,109,5.465931189462456
00501,844,LA LIBERTAD AVANZA,PRESIDENTE Y VICE,68,0,68,3.0841529511683943
00501,844,UNION POR LA PATRIA,DIPUTADO NACIONAL,86,0,86,4.129811689931641
00501,844,UNION POR LA PATRIA,PRESIDENTE Y VICE,88,0,88,4.245995994238668
00501,844,UNION POR LA PATRIA,SENADOR NACIONAL,86,0,86,4.129811689931641
00501,853,JUNTOS POR EL CAMBIO,DIPUTADO NACIONAL,83,0,83,3.9555352334710996
00501,853,JUNTOS POR EL CAMBIO,PRESIDENTE Y VICE,81,0,81,3.8393509291640724
00501,853,JUNTOS POR EL CAMBIO,SENADOR NACIONAL,83,0,83,3.9555352334710996
00501,853,UNION POR LA PATRIA,DIPUTADO NACIONAL,105,0,105,5.233562580848401
00501,853,UNION POR LA PATRIA,PRESIDENTE Y VICE,111,0,111,5.582115493769483
00501,853,UNION POR LA PATRIA,SENADOR NACIONAL,105,0,105,5.233562580848401
00501,861,JUNTOS POR EL CAMBIO,DIPUTADO NACIONAL,104,0,104,5.175470428694887
00501,861,JUNTOS POR EL CAMBIO,PRESIDENTE Y VICE,101,0,101,5.001193972234346
00501,861,JUNTOS POR EL CAMBIO,SENADOR NACIONAL,103,0,103,5.117378276541373
00501,861,UNION POR LA PATRIA,DIPUTADO NACIONAL,97,0,97,4.768825363620292
00501,861,UNION POR LA PATRIA,PRESIDENTE Y VICE,105,0,105,5.233562580848401
00501,861,UNION POR LA PATRIA,SENADOR NACIONAL,97,0,97,4.768825363620292
00501,862,UNION POR LA PATRIA,DIPUTADO NACIONAL,82,0,82,3.897443081317586
00501,862,UNION POR LA PATRIA,PRESIDENTE Y VICE,88,0,88,4.245995994238668
00501,862,UNION POR LA PATRIA,SENADOR NACIONAL,82,0,82,3.897443081317586
00501,874,JUNTOS POR EL CAMBIO,DIPUTADO NACIONAL,110,0,110,5.52402334161597
00501,874,JUNTOS POR EL CAMBIO,PRESIDENTE Y VICE,104,0,104,5.175470428694887
00501,874,JUNTOS POR EL CAMBIO,SENADOR NACIONAL,110,0,110,5.52402334161597
00501,874,UNION POR LA PATRIA,DIPUTADO NACIONAL,85,0,85,4.071719537778127
00501,874,UNION POR LA PATRIA,PRESIDENTE Y VICE,94,0,94,4.5945489071597505
00501,874,UNION POR LA PATRIA,SENADOR NACIONAL,91,0,91,4.420272450699209
00501,875,JUNTOS POR EL CAMBIO,DIPUTADO NACIONAL,105,0,105,5.233562580848401
00501,875,JUNTOS POR EL CAMBIO,PRESIDENTE Y VICE,97,0,97,4.768825363620292
00501,875,JUNTOS POR EL CAMBIO,SENADOR NACIONAL,105,0,105,5.233562580848401
00501,875,UNION POR LA PATRIA,DIPUTADO NACIONAL,99,0,99,4.885009667927319
00501,875,UNION POR LA PATRIA,PRESIDENTE Y VICE,111,0,111,5.582115493769483
00501,875,UNION POR LA PATRIA,SENADOR NACIONAL,103,0,103,5.117378276541373
00501,876,JUNTOS POR EL CAMBIO,DIPUTADO NACIONAL,96,0,96,4.710733211466778
00501,876,JUNTOS POR EL CAMBIO,PRESIDENTE Y VICE,93,0,93,4.5364567550062365
00501,876,JUNTOS POR EL CAMBIO,SENADOR NACIONAL,96,0,96,4.710733211466778
00501,876,UNION POR LA PATRIA,DIPUTADO NACIONAL,80,0,80,3.781258777010559
00501,876,UNION POR LA PATRIA,PRESIDENTE Y VICE,93,0,93,4.5364567550062365
00501,876,UNION POR LA PATRIA,SENADOR NACIONAL,84,0,84,4.013627385624614
00501,877,JUNTOS POR EL CAMBIO,DIPUTADO NACIONAL,105,0,105,5.233562580848401
00501,877,JUNTOS POR EL CAMBIO,PRESIDENTE Y VICE,95,0,95,4.652641059313264
00501,877,JUNTOS POR EL CAMBIO,SENADOR NACIONAL,102,0,102,5.05928612438786
00501,877,UNION POR LA PATRIA,DIPUTADO NACIONAL,76,0,76,3.548890168396504
00501,877,UNION POR LA PATRIA,PRESIDENTE Y VICE,90,0,90,4.362180298545695
00501,877,UNION POR LA PATRIA,SENADOR NACIONAL,82,0,82,3.897443081317586
00501,894,JUNTOS POR EL CAMBIO,DIPUTADO NACIONAL,104,0,104,5.175470428694887
00501,894,JUNTOS POR EL CAMBIO,PRESIDENTE Y VICE,95,0,95,4.652641059313264
00501,894,JUNTOS POR EL CAMBIO,SENADOR NACIONAL,103,0,103,5.117378276541373
00501,894,UNION POR LA PATRIA,DIPUTADO NACIONAL,88,0,88,4.245995994238668
00501,894,UNION POR LA PATRIA,PRESIDENTE Y VICE,96,0,96,4.710733211466778
00501,894,UNION POR LA PATRIA,SENADOR NACIONAL,90,0,90,4.362180298545695
00502,910,UNION POR LA PATRIA,PRESIDENTE Y VICE,121,21,100,4.943101820080833
00502,959,JUNTOS POR EL CAMBIO,DIPUTADO NACIONAL,92,0,92,4.478364602852723
00502,959,JUNTOS POR EL CAMBIO,PRESIDENTE Y VICE,84,0,84,4.013627385624614
00502,959,JUNTOS POR EL CAMBIO,SENADOR NACIONAL,92,0,92,4.478364602852723
00502,959,UNION POR LA PATRIA,DIPUTADO NACIONAL,107,0,107,5.349746885155429
00502,959,UNION POR LA PATRIA,PRESIDENTE Y VICE,112,0,112,5.640207645922997
00502,959,UNION POR LA PATRIA,SENADOR NACIONAL,110,0,110,5.52402334161597
00502,962,JUNTOS POR EL CAMBIO,DIPUTADO NACIONAL,0,107,107,5.349746885155429
00502,962,JUNTOS POR EL CAMBIO,PRESIDENTE Y VICE,0,115,115,5.814484102383538
00502,962,JUNTOS POR EL CAMBIO,SENADOR NACIONAL,0,107,107,5.349746885155429
00502,965,JUNTOS POR EL CAMBIO,DIPUTADO NACIONAL,89,0,89,4.304088146392182
00502,965,JUNTOS POR EL CAMBIO,PRESIDENTE Y VICE,83,0,83,3.9555352334710996
00502,965,JUNTOS POR EL CAMBIO,SENADOR NACIONAL,89,0,89,4.304088146392182
00502,965,UNION POR LA PATRIA,DIPUTADO NACIONAL,118,0,118,5.9887605588440795
00502,965,UNION POR LA PATRIA,PRESIDENTE Y VICE,122,0,122,6.221129167458134
00502,965,UNION POR LA PATRIA,SENADOR NACIONAL,118,0,118,5.9887605588440795
00502,979,JUNTOS POR EL CAMBIO,PRESIDENTE Y VICE,12,98,86,4.129811689931641
00502,980,JUNTOS POR EL CAMBIO,DIPUTADO NACIONAL,0,92,92,4.478364602852723
00502,980,JUNTOS POR EL CAMBIO,PRESIDENTE Y VICE,0,84,84,4.013627385624614
00502,980,JUNTOS POR EL CAMBIO,SENADOR NACIONAL,0,89,89,4.304088146392182
00502,980,UNION POR LA PATRIA,DIPUTADO NACIONAL,0,81,81,3.8393509291640724
00502,980,UNION POR LA PATRIA,PRESIDENTE Y VICE,0,80,80,3.781258777010559
00502,980,UNION POR LA PATRIA,SENADOR NACIONAL,0,82,82,3.897443081317586
00502,987,JUNTOS POR EL CAMBIO,DIPUTADO NACIONAL,113,0,113,5.69829979807651
00502,987,JUNTOS POR EL CAMBIO,PRESIDENTE Y VICE,108,0,108,5.407839037308942
00502,987,JUNTOS POR EL CAMBIO,SENADOR NACIONAL,112,0,112,5.640207645922997
00502,987,UNION POR LA PATRIA,DIPUTADO NACIONAL,75,0,75,3.49079801624299
00502,987,UNION POR LA PATRIA,PRESIDENTE Y VICE,88,0,88,4.245995994238668
00502,987,UNION POR LA PATRIA,SENADOR NACIONAL,77,0,77,3.6069823205500176
00502,994,JUNTOS POR EL CAMBIO,DIPUTADO NACIONAL,103,0,103,5.117378276541373
00502,994,JUNTOS POR EL CAMBIO,PRESIDENTE Y VICE,103,0,103,5.117378276541373
00502,994,JUNTOS POR EL CAMBIO,SENADOR NACIONAL,104,0,104,5.175470428694887
00502,994,LA LIBERTAD AVANZA,DIPUTADO NACIONAL,69,0,69,3.142245103321908
00502,994,LA LIBERTAD AVANZA,PRESIDENTE Y VICE,71,0,71,3.2584294076289355
00502,994,LA LIBERTAD AVANZA,SENADOR NACIONAL,68,0,68,3.0841529511683943
00502,994,UNION POR LA PATRIA,DIPUTADO NACIONAL,91,0,91,4.420272450699209
00502,994,UNION POR LA PATRIA,PRESIDENTE Y VICE,93,0,93,4.5364567550062365
00502,994,UNION POR LA PATRIA,SENADOR NACIONAL,93,0,93,4.5364567550062365
00502,1000,JUNTOS POR EL CAMBIO,DIPUTADO NACIONAL,89,0,89,4.304088146392182
00502,1000,JUNTOS POR EL CAMBIO,PRESIDENTE Y VICE,84,0,84,4.013627385624614
00502,1000,JUNTOS POR EL CAMBIO,SENADOR NACIONAL,89,0,89,4.304088146392182
00502,1000,LA LIBERTAD AVANZA,PRESIDENTE Y VICE,68,0,68,3.0841529511683943
00502,1000,UNION POR LA PATRIA,DIPUTADO NACIONAL,111,0,111,5.582115493769483
00502,1000,UNION POR LA PATRIA,PRESIDENTE Y VICE,117,0,117,5.9306684066905655
00502,1000,UNION POR LA PATRIA,SENADOR NACIONAL,113,0,113,5.69829979807651
00502,1001,JUNTOS POR EL CAMBIO,PRESIDENTE Y VICE,12,81,69,3.142245103321908
00502,1002,JUNTOS POR EL CAMBIO,DIPUTADO NACIONAL,77,0,77,3.6069823205500176
00502,1002,JUNTOS POR EL CAMBIO,PRESIDENTE Y VICE,74,0,74,3.4327058640894763
00502,1002,JUNTOS POR EL CAMBIO,SENADOR NACIONAL,77,0,77,3.6069823205500176
00502,1002,LA LIBERTAD AVANZA,PRESIDENTE Y VICE,70,0,70,3.2003372554754215
00502,1002,UNION POR LA PATRIA,DIPUTADO NACIONAL,120,0,120,6.104944863151107
00502,1002,UNION POR LA PATRIA,PRESIDENTE Y VICE,113,0,113,5.69829979807651
00502,1002,UNION POR LA PATRIA,SENADOR NACIONAL,110,0,110,5.52402334161597
00502,1003,JUNTOS POR EL CAMBIO,DIPUTADO NACIONAL,94,0,94,4.5945489071597505
00502,1003,JUNTOS POR EL CAMBIO,PRESIDENTE Y VICE,94,0,94,4.5945489071597505
00502,1003,JUNTOS POR EL CAMBIO,SENADOR NACIONAL,94,0,94,4.5945489071597505
00502,1003,UNION POR LA PATRIA,DIPUTADO NACIONAL,101,0,101,5.001193972234346
00502,1003,UNION POR LA PATRIA,PRESIDENTE Y VICE,105,0,105,5.233562580848401
00502,1003,UNION POR LA PATRIA,SENADOR NACIONAL,102,0,102,5.05928612438786
00502,1009,UNION POR LA PATRIA,SENADOR NACIONAL,105,13,92,4.478364602852723
00503,1030,LA LIBERTAD AVANZA,DIPUTADO NACIONAL,69,0,69,3.142245103321908
00503,1030,LA LIBERTAD AVANZA,PRESIDENTE Y VICE,75,0,75,3.49079801624299
00503,1030,LA LIBERTAD AVANZA,SENADOR NACIONAL,69,0,69,3.142245103321908
00503,1030,UNION POR LA PATRIA,DIPUTADO NACIONAL,103,0,103,5.117378276541373
00503,1030,UNION POR LA PATRIA,PRESIDENTE Y VICE,115,0,115,5.814484102383538
00503,1030,UNION POR LA PATRIA,SENADOR NACIONAL,108,0,108,5.407839037308942
00503,1031,LA LIBERTAD AVANZA,DIPUTADO NACIONAL,73,0,73,3.3746137119359627
00504,1076,JUNTOS POR EL CAMBIO,DIPUTADO NACIONAL,95,0,95,4.652641059313264
00504,1076,JUNTOS POR EL CAMBIO,PRESIDENTE Y VICE,92,0,92,4.478364602852723
00504,1076,JUNTOS POR EL CAMBIO,SENADOR NACIONAL,95,0,95,4.652641059313264
00504,1076,UNION POR LA PATRIA,DIPUTADO NACIONAL,84,0,84,4.013627385624614
00504,1076,UNION POR LA PATRIA,PRESIDENTE Y VICE,96,0,96,4.710733211466778
00504,1076,UNION POR LA PATRIA,SENADOR NACIONAL,89,0,89,4.304088146392182
00504,1087,JUNTOS POR EL CAMBIO,DIPUTADO NACIONAL,106,0,106,5.291654733001915
00504,1087,JUNTOS POR EL CAMBIO,PRESIDENTE Y VICE,101,0,101,5.001193972234346
00504,1087,JUNTOS POR EL CAMBIO,SENADOR NACIONAL,106,0,106,5.291654733001915
00504,1087,UNION POR LA PATRIA,DIPUTADO NACIONAL,108,0,108,5.407839037308942
00504,1087,UNION POR LA PATRIA,PRESIDENTE Y VICE,112,0,112,5.640207645922997
00504,1087,UNION POR LA PATRIA,SENADOR NACIONAL,111,0,111,5.582115493769483
00504,1112,UNION POR LA PATRIA,DIPUTADO NACIONAL,106,5,101,5.001193972234346
00504,1112,UNION POR LA PATRIA,SENADOR NACIONAL,110,6,104,5.175470428694887
00504,1114,JUNTOS POR EL CAMBIO,DIPUTADO NACIONAL,0,119,119,6.046852710997593
00504,1114,JUNTOS POR EL CAMBIO,PRESIDENTE Y VICE,0,118,118,5.9887605588440795
00504,1114,JUNTOS POR EL CAMBIO,SENADOR NACIONAL,0,119,119,6.046852710997593
00504,1146,LA LIBERTAD AVANZA,DIPUTADO NACIONAL,76,0,76,3.548890168396504
00504,1146,LA LIBERTAD AVANZA,PRESIDENTE Y VICE,75,0,75,3.49079801624299
00504,1146,LA LIBERTAD AVANZA,SENADOR NACIONAL,75,0,75,3.49079801624299
00504,1146,UNION POR LA PATRIA,DIPUTADO NACIONAL,108,0,108,5.407839037308942
00504,1146,UNION POR LA PATRIA,PRESIDENTE Y VICE,119,0,119,6.046852710997593
00504,1146,UNION POR LA PATRIA,SENADOR NACIONAL,115,0,115,5.814484102383538
00505,1258,JUNTOS POR EL CAMBIO,DIPUTADO NACIONAL,96,0,96,4.710733211466778
00505,1258,JUNTOS POR EL CAMBIO,PRESIDENTE Y VICE,93,0,93,4.5364567550062365
00505,1258,JUNTOS POR EL CAMBIO,SENADOR NACIONAL,95,0,95,4.652641059313264
00505,1258,UNION POR LA PATRIA,DIPUTADO NACIONAL,99,0,99,4.885009667927319
00505,1258,UNION POR LA PATRIA,PRESIDENTE Y VICE,103,0,103,5.117378276541373
00505,1258,UNION POR LA PATRIA,SENADOR NACIONAL,99,0,99,4.885009667927319
00505,1269,JUNTOS POR EL CAMBIO,DIPUTADO NACIONAL,0,74,74,3.4327058640894763
00505,1269,JUNTOS POR EL CAMBIO,PRESIDENTE Y VICE,0,75,75,3.49079801624299
00505,1269,JUNTOS POR EL CAMBIO,SENADOR NACIONAL,0,74,74,3.4327058640894763
00505,1269,UNION POR LA PATRIA,DIPUTADO NACIONAL,0,95,95,4.652641059313264
00505,1269,UNION POR LA PATRIA,PRESIDENTE Y VICE,0,93,93,4.5364567550062365
00505,1269,UNION POR LA PATRIA,SENADOR NACIONAL,0,95,95,4.652641059313264
00505,1270,JUNTOS POR EL CAMBIO,DIPUTADO NACIONAL,0,92,92,4.478364602852723
00505,1270,JUNTOS POR EL CAMBIO,PRESIDENTE Y VICE,0,88,88,4.245995994238668
00505,1270,JUNTOS POR EL CAMBIO,SENADOR NACIONAL,0,92,92,4.478364602852723
00505,1270,UNION POR LA PATRIA,DIPUTADO NACIONAL,0,79,79,3.7231666248570447
00505,1270,UNION POR LA PATRIA,PRESIDENTE Y VICE,0,82,82,3.897443081317586
00505,1270,UNION POR LA PATRIA,SENADOR NACIONAL,0,79,79,3.7231666248570447
00505,1271,JUNTOS POR EL CAMBIO,DIPUTADO NACIONAL,0,85,85,4.071719537778127
00505,1271,JUNTOS POR EL CAMBIO,PRESIDENTE Y VICE,0,86,86,4.129811689931641
00505,1271,JUNTOS POR EL CAMBIO,SENADOR NACIONAL,0,88,88,4.245995994238668
00505,1271,UNION POR LA PATRIA,DIPUTADO NACIONAL,0,91,91,4.420272450699209
00505,1271,UNION POR LA PATRIA,PRESIDENTE Y VICE,0,91,91,4.420272450699209
00505,1271,UNION POR LA PATRIA,SENADOR NACIONAL,0,92,92,4.478364602852723
00505,1272,JUNTOS POR EL CAMBIO,DIPUTADO NACIONAL,0,100,100,4.943101820080833
00505,1272,JUNTOS POR EL CAMBIO,PRESIDENTE Y VICE,0,93,93,4.5364567550062365
00505,1272,JUNTOS POR EL CAMBIO,SENADOR NACIONAL,0,99,99,4.885009667927319
00505,1272,UNION POR LA PATRIA,DIPUTADO NACIONAL,0,69,69,3.142245103321908
00505,1272,UNION POR LA PATRIA,PRESIDENTE Y VICE,0,69,69,3.142245103321908
00505,1272,UNION POR LA PATRIA,SENADOR NACIONAL,0,70,70,3.2003372554754215
00505,1274,LA LIBERTAD AVANZA,PRESIDENTE Y VICE,0,73,73,3.3746137119359627
00505,1274,UNION POR LA PATRIA,PRESIDENTE Y VICE,0,95,95,4.652641059313264
00505,1281,LA LIBERTAD AVANZA,PRESIDENTE Y VICE,68,0,68,3.0841529511683943
00505,1281,UNION POR LA PATRIA,DIPUTADO NACIONAL,96,0,96,4.710733211466778
00505,1281,UNION POR LA PATRIA,PRESIDENTE Y VICE,101,0,101,5.001193972234346
00505,1281,UNION POR LA PATRIA,SENADOR NACIONAL,96,0,96,4.710733211466778
00508,1350,UNION POR LA PATRIA,DIPUTADO NACIONAL,121,33,88,4.245995994238668
00508,1350,UNION POR LA PATRIA,SENADOR NACIONAL,121,34,87,4.187903842085155
00508,1353,UNION POR LA PATRIA,DIPUTADO NACIONAL,0,74,74,3.4327058640894763
00508,1353,UNION POR LA PATRIA,PRESIDENTE Y VICE,0,78,78,3.665074472703531
00508,1353,UNION POR LA PATRIA,SENADOR NACIONAL,0,74,74,3.4327058640894763
00509,1528,LA LIBERTAD AVANZA,DIPUTADO NACIONAL,0,69,69,3.142245103321908
00509,1528,LA LIBERTAD AVANZA,PRESIDENTE Y VICE,0,80,80,3.781258777010559
00509,1528,LA LIBERTAD AVANZA,SENADOR NACIONAL,0,70,70,3.2003372554754215
00509,1528,UNION POR LA PATRIA,DIPUTADO NACIONAL,0,81,81,3.8393509291640724
00509,1528,UNION POR LA PATRIA,PRESIDENTE Y VICE,0,81,81,3.8393509291640724
00509,1528,UNION POR LA PATRIA,SENADOR NACIONAL,0,81,81,3.8393509291640724
00509,1534,UNION POR LA PATRIA,SENADOR NACIONAL,108,40,68,3.0841529511683943
00509,1545,FRENTE DE IZQUIERDA Y DE TRABAJADORES - UNIDAD,DIPUTADO NACIONAL,68,0,68,3.0841529511683943
00509,1545,LA LIBERTAD AVANZA,DIPUTADO NACIONAL,68,0,68,3.0841529511683943
00509,1545,LA LIBERTAD AVANZA,PRESIDENTE Y VICE,73,0,73,3.3746137119359627
00509,1545,LA LIBERTAD AVANZA,SENADOR NACIONAL,68,0,68,3.0841529511683943
00509,1545,UNION POR LA PATRIA,DIPUTADO NACIONAL,115,0,115,5.814484102383538
00509,1545,UNION POR LA PATRIA,PRESIDENTE Y VICE,121,0,121,6.16303701530462
00509,1545,UNION POR LA PATRIA,SENADOR NACIONAL,116,0,116,5.8725762545370515
00509,1546,LA LIBERTAD AVANZA,DIPUTADO NACIONAL,69,0,69,3.142245103321908
00509,1546,LA LIBERTAD AVANZA,PRESIDENTE Y VICE,75,0,75,3.49079801624299
00509,1546,LA LIBERTAD AVANZA,SENADOR NACIONAL,69,0,69,3.142245103321908
00509,1546,UNION POR LA PATRIA,DIPUTADO NACIONAL,75,0,75,3.49079801624299
00509,1546,UNION POR LA PATRIA,PRESIDENTE Y VICE,77,0,77,3.6069823205500176
00509,1546,UNION POR LA PATRIA,SENADOR NACIONAL,75,0,75,3.49079801624299
00518,1598,JUNTOS POR EL CAMBIO,DIPUTADO NACIONAL,0,95,95,4.652641059313264
00518,1598,JUNTOS POR EL CAMBIO,PRESIDENTE Y VICE,0,97,97,4.768825363620292
00518,1598,JUNTOS POR EL CAMBIO,SENADOR NACIONAL,0,94,94,4.5945489071597505
00518,1598,UNION POR LA PATRIA,DIPUTADO NACIONAL,0,82,82,3.897443081317586
00518,1598,UNION POR LA PATRIA,PRESIDENTE Y VICE,0,85,85,4.071719537778127
00518,1598,UNION POR LA PATRIA,SENADOR NACIONAL,0,83,83,3.9555352334710996
00519,1602,UNION POR LA PATRIA,DIPUTADO NACIONAL,109,4,105,5.233562580848401
00519,1602,UNION POR LA PATRIA,PRESIDENTE Y VICE,118,3,115,5.814484102383538
00519,1602,UNION POR LA PATRIA,SENADOR NACIONAL,111,7,104,5.175470428694887
00519,1605,UNION POR LA PATRIA,DIPUTADO NACIONAL,110,0,110,5.52402334161597
00519,1605,UNION POR LA PATRIA,PRESIDENTE Y VICE,118,0,118,5.9887605588440795
00519,1605,UNION POR LA PATRIA,SENADOR NACIONAL,112,0,112,5.640207645922997
00520,1623,UNION POR LA PATRIA,PRESIDENTE Y VICE,12,92,80,3.781258777010559
00521,1645,JUNTOS POR EL CAMBIO,PRESIDENTE Y VICE,13,102,89,4.304088146392182
00521,1646,JUNTOS POR EL CAMBIO,DIPUTADO NACIONAL,0,104,104,5.175470428694887
00521,1646,JUNTOS POR EL CAMBIO,PRESIDENTE Y VICE,0,105,105,5.233562580848401
00521,1646,JUNTOS POR EL CAMBIO,SENADOR NACIONAL,0,103,103,5.117378276541373
00521,1646,UNION POR LA PATRIA,DIPUTADO NACIONAL,0,84,84,4.013627385624614
00521,1646,UNION POR LA PATRIA,PRESIDENTE Y VICE,0,88,88,4.245995994238668
00521,1646,UNION POR LA PATRIA,SENADOR NACIONAL,0,85,85,4.071719537778127
00521,1652,JUNTOS POR EL CAMBIO,DIPUTADO NACIONAL,103,0,103,5.117378276541373
00521,1652,JUNTOS POR EL CAMBIO,PRESIDENTE Y VICE,7,93,86,4.129811689931641
00521,1652,JUNTOS POR EL CAMBIO,SENADOR NACIONAL,103,0,103,5.117378276541373
00521,1652,UNION POR LA PATRIA,DIPUTADO NACIONAL,96,0,96,4.710733211466778
00521,1652,UNION POR LA PATRIA,SENADOR NACIONAL,97,0,97,4.768825363620292
00711,14,JUNTOS POR EL CAMBIO,DIPUTADO NACIONAL,105,0,105,5.233562580848401
00711,14,JUNTOS POR EL CAMBIO,PRESIDENTE Y VICE,95,0,95,4.652641059313264
00711,14,JUNTOS POR EL CAMBIO,SENADOR NACIONAL,105,0,105,5.233562580848401
00711,14,LA LIBERTAD AVANZA,PRESIDENTE Y VICE,67,0,67,3.0260607990148807
00711,14,UNION POR LA PATRIA,DIPUTADO NACIONAL,74,0,74,3.4327058640894763
00711,14,UNION POR LA PATRIA,PRESIDENTE Y VICE,79,0,79,3.7231666248570447
00711,14,UNION POR LA PATRIA,SENADOR NACIONAL,75,0,75,3.49079801624299
00711,15,FRENTE DE IZQUIERDA Y DE TRABAJADORES - UNIDAD,PRESIDENTE Y VICE,77,10,67,3.0260607990148807
00711,21,JUNTOS POR EL CAMBIO,DIPUTADO NACIONAL,0,100,100,4.943101820080833
00711,21,JUNTOS POR EL CAMBIO,PRESIDENTE Y VICE,0,101,101,5.001193972234346
00711,21,JUNTOS POR EL CAMBIO,SENADOR NACIONAL,0,100,100,4.943101820080833
00719,275,FRENTE DE IZQUIERDA Y DE TRABAJADORES - UNIDAD,PRESIDENTE Y VICE,13,89,76,3.548890168396504
00748,28,JUNTOS POR EL CAMBIO,DIPUTADO NACIONAL,122,0,122,6.221129167458134
00748,28,JUNTOS POR EL CAMBIO,PRESIDENTE Y VICE,118,0,118,5.9887605588440795
00748,28,JUNTOS POR EL CAMBIO,SENADOR NACIONAL,121,0,121,6.16303701530462
00748,28,LA LIBERTAD AVANZA,DIPUTADO NACIONAL,68,0,68,3.0841529511683943
00748,28,LA LIBERTAD AVANZA,PRESIDENTE Y VICE,73,0,73,3.3746137119359627
00748,28,LA LIBERTAD AVANZA,SENADOR NACIONAL,68,0,68,3.0841529511683943
00748,28,UNION POR LA PATRIA,PRESIDENTE Y VICE,71,0,71,3.2584294076289355
00748,28,UNION POR LA PATRIA,SENADOR NACIONAL,68,0,68,3.0841529511683943
00797,2,LA LIBERTAD AVANZA,PRESIDENTE Y VICE,73,0,73,3.3746137119359627
00797,2,UNION POR LA PATRIA,DIPUTADO NACIONAL,130,0,130,6.685866384686244
00797,2,UNION POR LA PATRIA,PRESIDENTE Y VICE,135,0,135,6.976327145453812
00797,2,UNION POR LA PATRIA,SENADOR NACIONAL,131,0,131,6.743958536839757
00797,4,LA LIBERTAD AVANZA,PRESIDENTE Y VICE,74,0,74,3.4327058640894763
00797,30,JUNTOS POR EL CAMBIO,PRESIDENTE Y VICE,0,69,69,3.142245103321908
00797,30,UNION POR LA PATRIA,DIPUTADO NACIONAL,0,90,90,4.362180298545695
00797,30,UNION POR LA PATRIA,PRESIDENTE Y VICE,0,90,90,4.362180298545695
00797,30,UNION POR LA PATRIA,SENADOR NACIONAL,0,86,86,4.129811689931641
00798,52,JUNTOS POR EL CAMBIO,DIPUTADO NACIONAL,0,86,86,4.129811689931641
00798,52,JUNTOS POR EL CAMBIO,PRESIDENTE Y VICE,0,87,87,4.187903842085155
00798,52,JUNTOS POR EL CAMBIO,SENADOR NACIONAL,0,85,85,4.071719537778127
00798,52,UNION POR LA PATRIA,DIPUTADO NACIONAL,0,92,92,4.478364602852723
00798,52,UNION POR LA PATRIA,PRESIDENTE Y VICE,0,100,100,4.943101820080833
00798,52,UNION POR LA PATRIA,SENADOR NACIONAL,0,92,92,4.478364602852723
00798,68,LA LIBERTAD AVANZA,PRESIDENTE Y VICE,81,0,81,3.8393509291640724
00800,73,JUNTOS POR EL CAMBIO,DIPUTADO NACIONAL,75,0,75,3.49079801624299
00800,73,JUNTOS POR EL CAMBIO,SENADOR NACIONAL,74,0,74,3.4327058640894763
00800,73,LA LIBERTAD AVANZA,PRESIDENTE Y VICE,73,0,73,3.3746137119359627
00800,73,UNION POR LA PATRIA,DIPUTADO NACIONAL,93,0,93,4.5364567550062365
00800,73,UNION POR LA PATRIA,PRESIDENTE Y VICE,102,0,102,5.05928612438786
00800,73,UNION POR LA PATRIA,SENADOR NACIONAL,93,0,93,4.5364567550062365
00800,74,JUNTOS POR EL CAMBIO,DIPUTADO NACIONAL,0,92,92,4.478364602852723
00800,74,JUNTOS POR EL CAMBIO,SENADOR NACIONAL,0,92,92,4.478364602852723
00804,93,JUNTOS POR EL CAMBIO,DIPUTADO NACIONAL,0,114,114,5.756391950230024
00804,93,JUNTOS POR EL CAMBIO,PRESIDENTE Y VICE,0,111,111,5.582115493769483
00804,93,JUNTOS POR EL CAMBIO,SENADOR NACIONAL,0,113,113,5.69829979807651
00823,10,JUNTOS POR EL CAMBIO,DIPUTADO NACIONAL,0,116,116,5.8725762545370515
00823,10,JUNTOS POR EL CAMBIO,SENADOR NACIONAL,0,114,114,5.756391950230024
00823,24,LA LIBERTAD AVANZA,PRESIDENTE Y VICE,76,6,70,3.2003372554754215
00823,33,JUNTOS POR EL CAMBIO,DIPUTADO NACIONAL,105,29,76,3.548890168396504
00823,41,JUNTOS POR EL CAMBIO,PRESIDENTE Y VICE,89,198,109,5.465931189462456
00823,46,JUNTOS POR EL CAMBIO,DIPUTADO NACIONAL,79,0,79,3.7231666248570447
00823,46,JUNTOS POR EL CAMBIO,PRESIDENTE Y VICE,68,0,68,3.0841529511683943
00823,46,JUNTOS POR EL CAMBIO,SENADOR NACIONAL,79,0,79,3.7231666248570447
00823,46,LA LIBERTAD AVANZA,DIPUTADO NACIONAL,69,0,69,3.142245103321908
00823,46,LA LIBERTAD AVANZA,PRESIDENTE Y VICE,84,0,84,4.013627385624614
00823,46,LA LIBERTAD AVANZA,SENADOR NACIONAL,71,0,71,3.2584294076289355
00823,46,UNION POR LA PATRIA,DIPUTADO NACIONAL,85,0,85,4.071719537778127
00823,46,UNION POR LA PATRIA,PRESIDENTE Y VICE,88,0,88,4.245995994238668
00823,46,UNION POR LA PATRIA,SENADOR NACIONAL,80,0,80,3.781258777010559
00832,12,HACEMOS POR NUESTRO PAIS,PRESIDENTE Y VICE,73,0,73,3.3746137119359627
00832,28,LA LIBERTAD AVANZA,PRESIDENTE Y VICE,69,0,69,3.142245103321908
00846,4,LA LIBERTAD AVANZA,PRESIDENTE Y VICE,98,16,82,3.897443081317586
00854,42,LA LIBERTAD AVANZA,DIPUTADO NACIONAL,81,0,81,3.8393509291640724
00854,76,LA LIBERTAD AVANZA,PRESIDENTE Y VICE,0,76,76,3.548890168396504
00854,76,UNION POR LA PATRIA,DIPUTADO NACIONAL,0,87,87,4.187903842085155
00854,76,UNION POR LA PATRIA,PRESIDENTE Y VICE,0,87,87,4.187903842085155
00854,76,UNION POR LA PATRIA,SENADOR NACIONAL,0,87,87,4.187903842085155
00860,5,JUNTOS POR EL CAMBIO,PRESIDENTE Y VICE,69,0,69,3.142245103321908
00860,5,LA LIBERTAD AVANZA,DIPUTADO NACIONAL,71,0,71,3.2584294076289355
00860,5,LA LIBERTAD AVANZA,PRESIDENTE Y VICE,85,0,85,4.071719537778127
00860,5,LA LIBERTAD AVANZA,SENADOR NACIONAL,71,0,71,3.2584294076289355
00860,5,UNION POR LA PATRIA,DIPUTADO NACIONAL,68,0,68,3.0841529511683943
00860,5,UNION POR LA PATRIA,PRESIDENTE Y VICE,80,0,80,3.781258777010559
00860,5,UNION POR LA PATRIA,SENADOR NACIONAL,68,0,68,3.0841529511683943
00860,16,JUNTOS POR EL CAMBIO,DIPUTADO NACIONAL,77,0,77,3.6069823205500176
00860,16,JUNTOS POR EL CAMBIO,PRESIDENTE Y VICE,74,0,74,3.4327058640894763
00860,16,JUNTOS POR EL CAMBIO,SENADOR NACIONAL,75,0,75,3.49079801624299
00860,16,LA LIBERTAD AVANZA,DIPUTADO NACIONAL,78,0,78,3.665074472703531
00860,16,LA LIBERTAD AVANZA,PRESIDENTE Y VICE,90,0,90,4.362180298545695
00860,16,LA LIBERTAD AVANZA,SENADOR NACIONAL,79,0,79,3.7231666248570447
00860,16,UNION POR LA PATRIA,DIPUTADO NACIONAL,102,0,102,5.05928612438786
00860,16,UNION POR LA PATRIA,PRESIDENTE Y VICE,106,0,106,5.291654733001915
00860,16,UNION POR LA PATRIA,SENADOR NACIONAL,104,0,104,5.175470428694887
00864,60,LA LIBERTAD AVANZA,PRESIDENTE Y VICE,73,0,73,3.3746137119359627
00866,7,JUNTOS POR EL CAMBIO,DIPUTADO NACIONAL,104,0,104,5.175470428694887
00866,7,JUNTOS POR EL CAMBIO,PRESIDENTE Y VICE,94,0,94,4.5945489071597505
00866,7,JUNTOS POR EL CAMBIO,SENADOR NACIONAL,104,0,104,5.175470428694887
00866,7,LA LIBERTAD AVANZA,PRESIDENTE Y VICE,74,0,74,3.4327058640894763
00866,7,UNION POR LA PATRIA,DIPUTADO NACIONAL,85,0,85,4.071719537778127
00866,7,UNION POR LA PATRIA,PRESIDENTE Y VICE,88,0,88,4.245995994238668
00866,7,UNION POR LA PATRIA,SENADOR NACIONAL,85,0,85,4.071719537778127
00866,10,JUNTOS POR EL CAMBIO,SENADOR NACIONAL,4,84,80,3.781258777010559
00866,25,JUNTOS POR EL CAMBIO,DIPUTADO NACIONAL,86,0,86,4.129811689931641
00866,25,JUNTOS POR EL CAMBIO,PRESIDENTE Y VICE,78,0,78,3.665074472703531
00866,25,JUNTOS POR EL CAMBIO,SENADOR NACIONAL,86,0,86,4.129811689931641
00866,25,LA LIBERTAD AVANZA,DIPUTADO NACIONAL,83,0,83,3.9555352334710996
00866,25,LA LIBERTAD AVANZA,PRESIDENTE Y VICE,101,0,101,5.001193972234346
00866,25,LA LIBERTAD AVANZA,SENADOR NACIONAL,83,0,83,3.9555352334710996
00866,25,UNION POR LA PATRIA,DIPUTADO NACIONAL,79,0,79,3.7231666248570447
00866,25,UNION POR LA PATRIA,PRESIDENTE Y VICE,83,0,83,3.9555352334710996
00866,25,UNION POR LA PATRIA,SENADOR NACIONAL,79,0,79,3.7231666248570447
00866,35,JUNTOS POR EL CAMBIO,DIPUTADO NACIONAL,0,106,106,5.291654733001915
00866,35,JUNTOS POR EL CAMBIO,PRESIDENTE Y VICE,0,105,105,5.233562580848401
00866,35,JUNTOS POR EL CAMBIO,SENADOR NACIONAL,0,106,106,5.291654733001915
00866,48,JUNTOS POR EL CAMBIO,DIPUTADO NACIONAL,0,106,106,5.291654733001915
00866,48,JUNTOS POR EL CAMBIO,PRESIDENTE Y VICE,0,104,104,5.175470428694887
00866,48,JUNTOS POR EL CAMBIO,SENADOR NACIONAL,0,106,106,5.291654733001915
00866,51,LA LIBERTAD AVANZA,PRESIDENTE Y VICE,90,3,87,4.187903842085155
00870,62,LA LIBERTAD AVANZA,DIPUTADO NACIONAL,82,0,82,3.897443081317586
00870,62,LA LIBERTAD AVANZA,PRESIDENTE Y VICE,86,0,86,4.129811689931641
00870,62,LA LIBERTAD AVANZA,SENADOR NACIONAL,81,0,81,3.8393509291640724
00870,62,UNION POR LA PATRIA,DIPUTADO NACIONAL,110,0,110,5.52402334161597
00870,62,UNION POR LA PATRIA,PRESIDENTE Y VICE,114,0,114,5.756391950230024
00870,62,UNION POR LA PATRIA,SENADOR NACIONAL,109,0,109,5.465931189462456
00901,10,JUNTOS POR EL CAMBIO,DIPUTADO NACIONAL,30,107,77,3.6069823205500176
00901,10,JUNTOS POR EL CAMBIO,SENADOR NACIONAL,28,105,77,3.6069823205500176
00901,38,JUNTOS POR EL CAMBIO,SENADOR NACIONAL,11,113,102,5.05928612438786
00901,60,JUNTOS POR EL CAMBIO,DIPUTADO NACIONAL,108,41,67,3.0260607990148807
00901,60,UNION POR LA PATRIA,DIPUTADO NACIONAL,84,8,76,3.548890168396504
00901,60,UNION POR LA PATRIA,SENADOR NACIONAL,85,9,76,3.548890168396504
00901,94,JUNTOS POR EL CAMBIO,DIPUTADO NACIONAL,89,0,89,4.304088146392182
00901,94,JUNTOS POR EL CAMBIO,PRESIDENTE Y VICE,87,0,87,4.187903842085155
00901,94,JUNTOS POR EL CAMBIO,SENADOR NACIONAL,91,0,91,4.420272450699209
00901,94,LA LIBERTAD AVANZA,PRESIDENTE Y VICE,72,0,72,3.316521559782449
00901,94,UNION POR LA PATRIA,DIPUTADO NACIONAL,72,0,72,3.316521559782449
00901,94,UNION POR LA PATRIA,PRESIDENTE Y VICE,72,0,72,3.316521559782449
00901,94,UNION POR LA PATRIA,SENADOR NACIONAL,72,0,72,3.316521559782449
00902,212,UNION POR LA PATRIA,DIPUTADO NACIONAL,95,0,95,4.652641059313264
00903,216,UNION POR LA PATRIA,DIPUTADO NACIONAL,102,30,72,3.316521559782449
00903,216,UNION POR LA PATRIA,PRESIDENTE Y VICE,112,17,95,4.652641059313264
00903,216,UNION POR LA PATRIA,SENADOR NACIONAL,103,35,68,3.0841529511683943
00903,224,LA LIBERTAD AVANZA,DIPUTADO NACIONAL,83,0,83,3.9555352334710996
00903,224,LA LIBERTAD AVANZA,PRESIDENTE Y VICE,100,0,100,4.943101820080833
00903,224,LA LIBERTAD AVANZA,SENADOR NACIONAL,84,0,84,4.013627385624614
00903,224,UNION POR LA PATRIA,DIPUTADO NACIONAL,95,0,95,4.652641059313264
00903,224,UNION POR LA PATRIA,PRESIDENTE Y VICE,104,0,104,5.175470428694887
00903,224,UNION POR LA PATRIA,SENADOR NACIONAL,96,0,96,4.710733211466778
00903,232,JUNTOS POR EL CAMBIO,PRESIDENTE Y VICE,0,67,67,3.0260607990148807
00903,232,LA LIBERTAD AVANZA,PRESIDENTE Y VICE,0,78,78,3.665074472703531
00903,232,UNION POR LA PATRIA,PRESIDENTE Y VICE,0,71,71,3.2584294076289355
00904,242,LA LIBERTAD AVANZA,DIPUTADO NACIONAL,68,0,68,3.0841529511683943
00904,242,LA LIBERTAD AVANZA,PRESIDENTE Y VICE,78,0,78,3.665074472703531
00904,242,LA LIBERTAD AVANZA,SENADOR NACIONAL,68,0,68,3.0841529511683943
00904,242,UNION POR LA PATRIA,DIPUTADO NACIONAL,105,0,105,5.233562580848401
00904,242,UNION POR LA PATRIA,PRESIDENTE Y VICE,116,0,116,5.8725762545370515
00904,242,UNION POR LA PATRIA,SENADOR NACIONAL,106,0,106,5.291654733001915
00904,252,JUNTOS POR EL CAMBIO,DIPUTADO NACIONAL,72,0,72,3.316521559782449
00904,252,JUNTOS POR EL CAMBIO,SENADOR NACIONAL,71,0,71,3.2584294076289355
00904,252,LA LIBERTAD AVANZA,DIPUTADO NACIONAL,80,0,80,3.781258777010559
00904,252,LA LIBERTAD AVANZA,PRESIDENTE Y VICE,90,0,90,4.362180298545695
00904,252,LA LIBERTAD AVANZA,SENADOR NACIONAL,81,0,81,3.8393509291640724
00904,252,UNION POR LA PATRIA,DIPUTADO NACIONAL,91,0,91,4.420272450699209
00904,252,UNION POR LA PATRIA,PRESIDENTE Y VICE,102,0,102,5.05928612438786
00904,252,UNION POR LA PATRIA,SENADOR NACIONAL,91,0,91,4.420272450699209
00904,270,UNION POR LA PATRIA,DIPUTADO NACIONAL,99,26,73,3.3746137119359627
00904,270,UNION POR LA PATRIA,PRESIDENTE Y VICE,114,33,81,3.8393509291640724
00904,270,UNION POR LA PATRIA,SENADOR NACIONAL,101,28,73,3.3746137119359627
00904,275,JUNTOS POR EL CAMBIO,PRESIDENTE Y VICE,0,77,77,3.6069823205500176
00904,293,JUNTOS POR EL CAMBIO,DIPUTADO NACIONAL,67,0,67,3.0260607990148807
00904,293,JUNTOS POR EL CAMBIO,PRESIDENTE Y VICE,69,0,69,3.142245103321908
00904,293,JUNTOS POR EL CAMBIO,SENADOR NACIONAL,68,0,68,3.0841529511683943
00904,293,LA LIBERTAD AVANZA,DIPUTADO NACIONAL,84,0,84,4.013627385624614
00904,293,LA LIBERTAD AVANZA,PRESIDENTE Y VICE,86,0,86,4.129811689931641
00904,293,LA LIBERTAD AVANZA,SENADOR NACIONAL,83,0,83,3.9555352334710996
00904,293,UNION POR LA PATRIA,DIPUTADO NACIONAL,70,0,70,3.2003372554754215
00904,293,UNION POR LA PATRIA,PRESIDENTE Y VICE,74,0,74,3.4327058640894763
00904,293,UNION POR LA PATRIA,SENADOR NACIONAL,71,0,71,3.2584294076289355
00904,295,LA LIBERTAD AVANZA,DIPUTADO NACIONAL,77,0,77,3.6069823205500176
00904,295,LA LIBERTAD AVANZA,PRESIDENTE Y VICE,83,0,83,3.9555352334710996
00904,295,LA LIBERTAD AVANZA,SENADOR NACIONAL,77,0,77,3.6069823205500176
00904,295,UNION POR LA PATRIA,DIPUTADO NACIONAL,80,0,80,3.781258777010559
00904,295,UNION POR LA PATRIA,PRESIDENTE Y VICE,93,0,93,4.5364567550062365
00904,295,UNION POR LA PATRIA,SENADOR NACIONAL,81,0,81,3.8393509291640724
00904,297,LA LIBERTAD AVANZA,PRESIDENTE Y VICE,75,0,75,3.49079801624299
00904,297,UNION POR LA PATRIA,DIPUTADO NACIONAL,114,0,114,5.756391950230024
00904,297,UNION POR LA PATRIA,PRESIDENTE Y VICE,125,0,125,6.395405623918675
00904,297,UNION POR LA PATRIA,SENADOR NACIONAL,116,0,116,5.8725762545370515
00905,322,JUNTOS POR EL CAMBIO,DIPUTADO NACIONAL,0,94,94,4.5945489071597505
00905,322,JUNTOS POR EL CAMBIO,PRESIDENTE Y VICE,0,91,91,4.420272450699209
00905,322,JUNTOS POR EL CAMBIO,SENADOR NACIONAL,0,94,94,4.5945489071597505
00905,322,UNION POR LA PATRIA,DIPUTADO NACIONAL,0,77,77,3.6069823205500176
00905,322,UNION POR LA PATRIA,PRESIDENTE Y VICE,0,81,81,3.8393509291640724
00905,322,UNION POR LA PATRIA,SENADOR NACIONAL,0,77,77,3.6069823205500176
00905,324,LA LIBERTAD AVANZA,PRESIDENTE Y VICE,68,0,68,3.0841529511683943
00905,324,UNION POR LA PATRIA,DIPUTADO NACIONAL,86,0,86,4.129811689931641
00905,324,UNION POR LA PATRIA,SENADOR NACIONAL,84,0,84,4.013627385624614
00905,327,LA LIBERTAD AVANZA,PRESIDENTE Y VICE,0,71,71,3.2584294076289355
00905,327,UNION POR LA PATRIA,DIPUTADO NACIONAL,0,99,99,4.885009667927319
00905,327,UNION POR LA PATRIA,PRESIDENTE Y VICE,0,99,99,4.885009667927319
00905,327,UNION POR LA PATRIA,SENADOR NACIONAL,0,99,99,4.885009667927319
00905,332,UNION POR LA PATRIA,DIPUTADO NACIONAL,0,95,95,4.652641059313264
00905,332,UNION POR LA PATRIA,PRESIDENTE Y VICE,0,95,95,4.652641059313264
00905,332,UNION POR LA PATRIA,SENADOR NACIONAL,0,95,95,4.652641059313264
00906,337,JUNTOS POR EL CAMBIO,DIPUTADO NACIONAL,0,94,94,4.5945489071597505
00906,337,JUNTOS POR EL CAMBIO,PRESIDENTE Y VICE,0,94,94,4.5945489071597505
00906,337,JUNTOS POR EL CAMBIO,SENADOR NACIONAL,0,100,100,4.943101820080833
00906,337,UNION POR LA PATRIA,DIPUTADO NACIONAL,0,80,80,3.781258777010559
00906,337,UNION POR LA PATRIA,PRESIDENTE Y VICE,0,83,83,3.9555352334710996
00906,337,UNION POR LA PATRIA,SENADOR NACIONAL,0,81,81,3.8393509291640724
00908,349,JUNTOS POR EL CAMBIO,DIPUTADO NACIONAL,72,0,72,3.316521559782449
00908,349,JUNTOS POR EL CAMBIO,PRESIDENTE Y VICE,70,0,70,3.2003372554754215
00908,349,JUNTOS POR EL CAMBIO,SENADOR NACIONAL,72,0,72,3.316521559782449
00908,349,LA LIBERTAD AVANZA,PRESIDENTE Y VICE,70,0,70,3.2003372554754215
00908,349,UNION POR LA PATRIA,DIPUTADO NACIONAL,83,0,83,3.9555352334710996
00908,349,UNION POR LA PATRIA,PRESIDENTE Y VICE,100,0,100,4.943101820080833
00908,349,UNION POR LA PATRIA,SENADOR NACIONAL,85,0,85,4.071719537778127
00913,4,LA LIBERTAD AVANZA,DIPUTADO NACIONAL,78,0,78,3.665074472703531
00913,4,LA LIBERTAD AVANZA,PRESIDENTE Y VICE,86,0,86,4.129811689931641
00913,4,LA LIBERTAD AVANZA,SENADOR NACIONAL,79,0,79,3.7231666248570447
00913,4,UNION POR LA PATRIA,DIPUTADO NACIONAL,88,0,88,4.245995994238668
00913,4,UNION POR LA PATRIA,PRESIDENTE Y VICE,100,0,100,4.943101820080833
00913,4,UNION POR LA PATRIA,SENADOR NACIONAL,88,0,88,4.245995994238668
00913,18,JUNTOS POR EL CAMBIO,DIPUTADO NACIONAL,0,75,75,3.49079801624299
00913,18,JUNTOS POR EL CAMBIO,PRESIDENTE Y VICE,0,79,79,3.7231666248570447
00913,18,JUNTOS POR EL CAMBIO,SENADOR NACIONAL,0,77,77,3.6069823205500176
00913,18,LA LIBERTAD AVANZA,DIPUTADO NACIONAL,0,67,67,3.0260607990148807
00913,18,LA LIBERTAD AVANZA,PRESIDENTE Y VICE,0,76,76,3.548890168396504
00913,18,LA LIBERTAD AVANZA,SENADOR NACIONAL,0,67,67,3.0260607990148807
00913,18,UNION POR LA PATRIA,DIPUTADO NACIONAL,0,72,72,3.316521559782449
00913,18,UNION POR LA PATRIA,SENADOR NACIONAL,0,71,71,3.2584294076289355
00913,19,HACEMOS POR NUESTRO PAIS,PRESIDENTE Y VICE,90,4,86,4.129811689931641
00913,25,JUNTOS POR EL CAMBIO,DIPUTADO NACIONAL,74,0,74,3.4327058640894763
00913,25,JUNTOS POR EL CAMBIO,PRESIDENTE Y VICE,73,0,73,3.3746137119359627
00913,25,JUNTOS POR EL CAMBIO,SENADOR NACIONAL,73,0,73,3.3746137119359627
00913,25,LA LIBERTAD AVANZA,DIPUTADO NACIONAL,99,0,99,4.885009667927319
00913,25,LA LIBERTAD AVANZA,PRESIDENTE Y VICE,111,0,111,5.582115493769483
00913,25,LA LIBERTAD AVANZA,SENADOR NACIONAL,100,0,100,4.943101820080833
00913,25,UNION POR LA PATRIA,DIPUTADO NACIONAL,67,0,67,3.0260607990148807
00913,25,UNION POR LA PATRIA,PRESIDENTE Y VICE,78,0,78,3.665074472703531
00913,25,UNION POR LA PATRIA,SENADOR NACIONAL,69,0,69,3.142245103321908
00913,35,LA LIBERTAD AVANZA,DIPUTADO NACIONAL,80,0,80,3.781258777010559
00913,35,LA LIBERTAD AVANZA,SENADOR NACIONAL,80,0,80,3.781258777010559
00913,69,JUNTOS POR EL CAMBIO,DIPUTADO NACIONAL,0,79,79,3.7231666248570447
00913,69,JUNTOS POR EL CAMBIO,PRESIDENTE Y VICE,0,85,85,4.071719537778127
00913,69,JUNTOS POR EL CAMBIO,SENADOR NACIONAL,0,81,81,3.8393509291640724
00913,69,LA LIBERTAD AVANZA,DIPUTADO NACIONAL,0,69,69,3.142245103321908
00913,69,LA LIBERTAD AVANZA,PRESIDENTE Y VICE,0,81,81,3.8393509291640724
00913,69,LA LIBERTAD AVANZA,SENADOR NACIONAL,0,69,69,3.142245103321908
00913,71,UNION POR LA PATRIA,DIPUTADO NACIONAL,86,15,71,3.2584294076289355
00913,71,UNION POR LA PATRIA,SENADOR NACIONAL,88,15,73,3.3746137119359627
00913,77,LA LIBERTAD AVANZA,DIPUTADO NACIONAL,73,0,73,3.3746137119359627
00913,77,LA LIBERTAD AVANZA,PRESIDENTE Y VICE,86,0,86,4.129811689931641
00913,77,LA LIBERTAD AVANZA,SENADOR NACIONAL,74,0,74,3.4327058640894763
00913,85,LA LIBERTAD AVANZA,DIPUTADO NACIONAL,88,0,88,4.245995994238668
00913,85,LA LIBERTAD AVANZA,PRESIDENTE Y VICE,93,0,93,4.5364567550062365
00913,85,LA LIBERTAD AVANZA,SENADOR NACIONAL,88,0,88,4.245995994238668
00913,85,UNION POR LA PATRIA,DIPUTADO NACIONAL,80,0,80,3.781258777010559
00913,85,UNION POR LA PATRIA,PRESIDENTE Y VICE,92,0,92,4.478364602852723
00913,85,UNION POR LA PATRIA,SENADOR NACIONAL,82,0,82,3.897443081317586
00913,90,LA LIBERTAD AVANZA,DIPUTADO NACIONAL,83,0,83,3.9555352334710996
00913,90,LA LIBERTAD AVANZA,SENADOR NACIONAL,88,0,88,4.245995994238668
00913,90,UNION POR LA PATRIA,DIPUTADO NACIONAL,70,0,70,3.2003372554754215
00913,90,UNION POR LA PATRIA,PRESIDENTE Y VICE,80,0,80,3.781258777010559
00913,90,UNION POR LA PATRIA,SENADOR NACIONAL,72,0,72,3.316521559782449
00913,91,LA LIBERTAD AVANZA,DIPUTADO NACIONAL,87,0,87,4.187903842085155
00913,91,LA LIBERTAD AVANZA,PRESIDENTE Y VICE,95,0,95,4.652641059313264
00913,91,LA LIBERTAD AVANZA,SENADOR NACIONAL,87,0,87,4.187903842085155
00913,91,UNION POR LA PATRIA,DIPUTADO NACIONAL,87,0,87,4.187903842085155
00913,91,UNION POR LA PATRIA,PRESIDENTE Y VICE,94,0,94,4.5945489071597505
00913,91,UNION POR LA PATRIA,SENADOR NACIONAL,87,0,87,4.187903842085155
00913,97,LA LIBERTAD AVANZA,DIPUTADO NACIONAL,87,0,87,4.187903842085155
00913,97,LA LIBERTAD AVANZA,PRESIDENTE Y VICE,95,0,95,4.652641059313264
00913,97,LA LIBERTAD AVANZA,SENADOR NACIONAL,87,0,87,4.187903842085155
00913,97,UNION POR LA PATRIA,DIPUTADO NACIONAL,89,0,89,4.304088146392182
00913,97,UNION POR LA PATRIA,PRESIDENTE Y VICE,100,0,100,4.943101820080833
00913,97,UNION POR LA PATRIA,SENADOR NACIONAL,89,0,89,4.304088146392182
00913,99,JUNTOS POR EL CAMBIO,DIPUTADO NACIONAL,77,0,77,3.6069823205500176
00913,99,JUNTOS POR EL CAMBIO,PRESIDENTE Y VICE,74,0,74,3.4327058640894763
00913,99,JUNTOS POR EL CAMBIO,SENADOR NACIONAL,78,0,78,3.665074472703531
00913,99,LA LIBERTAD AVANZA,DIPUTADO NACIONAL,84,0,84,4.013627385624614
00913,99,LA LIBERTAD AVANZA,PRESIDENTE Y VICE,82,0,82,3.897443081317586
00913,99,LA LIBERTAD AVANZA,SENADOR NACIONAL,84,0,84,4.013627385624614
00913,99,UNION POR LA PATRIA,DIPUTADO NACIONAL,73,0,73,3.3746137119359627
00913,99,UNION POR LA PATRIA,PRESIDENTE Y VICE,83,0,83,3.9555352334710996
00913,99,UNION POR LA PATRIA,SENADOR NACIONAL,72,0,72,3.316521559782449
00913,101,LA LIBERTAD AVANZA,DIPUTADO NACIONAL,92,0,92,4.478364602852723
00913,101,LA LIBERTAD AVANZA,PRESIDENTE Y VICE,98,0,98,4.826917515773805
00913,101,LA LIBERTAD AVANZA,SENADOR NACIONAL,92,0,92,4.478364602852723
00913,101,UNION POR LA PATRIA,DIPUTADO NACIONAL,84,0,84,4.013627385624614
00913,101,UNION POR LA PATRIA,PRESIDENTE Y VICE,87,0,87,4.187903842085155
00913,101,UNION POR LA PATRIA,SENADOR NACIONAL,84,0,84,4.013627385624614
00913,103,JUNTOS POR EL CAMBIO,DIPUTADO NACIONAL,0,84,84,4.013627385624614
00913,103,JUNTOS POR EL CAMBIO,PRESIDENTE Y VICE,0,90,90,4.362180298545695
00913,103,JUNTOS POR EL CAMBIO,SENADOR NACIONAL,0,84,84,4.013627385624614
00913,103,LA LIBERTAD AVANZA,PRESIDENTE Y VICE,0,79,79,3.7231666248570447
00913,106,JUNTOS POR EL CAMBIO,PRESIDENTE Y VICE,71,0,71,3.2584294076289355
00913,106,JUNTOS POR EL CAMBIO,SENADOR NACIONAL,67,0,67,3.0260607990148807
00913,106,LA LIBERTAD AVANZA,DIPUTADO NACIONAL,81,0,81,3.8393509291640724
00913,106,LA LIBERTAD AVANZA,PRESIDENTE Y VICE,89,0,89,4.304088146392182
00913,106,LA LIBERTAD AVANZA,SENADOR NACIONAL,80,0,80,3.781258777010559
00913,106,UNION POR LA PATRIA,DIPUTADO NACIONAL,77,0,77,3.6069823205500176
00913,106,UNION POR LA PATRIA,PRESIDENTE Y VICE,85,0,85,4.071719537778127
00913,106,UNION POR LA PATRIA,SENADOR NACIONAL,78,0,78,3.665074472703531
00913,124,JUNTOS POR EL CAMBIO,DIPUTADO NACIONAL,70,0,70,3.2003372554754215
00913,124,JUNTOS POR EL CAMBIO,PRESIDENTE Y VICE,67,0,67,3.0260607990148807
00913,124,JUNTOS POR EL CAMBIO,SENADOR NACIONAL,69,0,69,3.142245103321908
00913,124,LA LIBERTAD AVANZA,DIPUTADO NACIONAL,72,0,72,3.316521559782449
00913,124,LA LIBERTAD AVANZA,PRESIDENTE Y VICE,74,0,74,3.4327058640894763
00913,124,LA LIBERTAD AVANZA,SENADOR NACIONAL,72,0,72,3.316521559782449
00913,124,UNION POR LA PATRIA,DIPUTADO NACIONAL,72,0,72,3.316521559782449
00913,124,UNION POR LA PATRIA,PRESIDENTE Y VICE,77,0,77,3.6069823205500176
00913,124,UNION POR LA PATRIA,SENADOR NACIONAL,73,0,73,3.3746137119359627
00917,144,LA LIBERTAD AVANZA,DIPUTADO NACIONAL,78,0,78,3.665074472703531
00917,144,LA LIBERTAD AVANZA,PRESIDENTE Y VICE,84,0,84,4.013627385624614
00917,144,LA LIBERTAD AVANZA,SENADOR NACIONAL,78,0,78,3.665074472703531
00917,144,UNION POR LA PATRIA,DIPUTADO NACIONAL,144,0,144,7.499156514835435
00917,144,UNION POR LA PATRIA,PRESIDENTE Y VICE,148,0,148,7.73152512344949
00917,144,UNION POR LA PATRIA,SENADOR NACIONAL,145,0,145,7.557248666988949
00922,158,LA LIBERTAD AVANZA,DIPUTADO NACIONAL,82,0,82,3.897443081317586
00922,158,LA LIBERTAD AVANZA,PRESIDENTE Y VICE,80,0,80,3.781258777010559
00922,158,LA LIBERTAD AVANZA,SENADOR NACIONAL,82,0,82,3.897443081317586
00922,158,UNION POR LA PATRIA,PRESIDENTE Y VICE,111,39,72,3.316521559782449
00944,14,JUNTOS POR EL CAMBIO,DIPUTADO NACIONAL,88,0,88,4.245995994238668
00944,14,JUNTOS POR EL CAMBIO,PRESIDENTE Y VICE,86,0,86,4.129811689931641
00944,14,JUNTOS POR EL CAMBIO,SENADOR NACIONAL,88,0,88,4.245995994238668
00944,14,LA LIBERTAD AVANZA,PRESIDENTE Y VICE,69,0,69,3.142245103321908
00944,14,UNION POR LA PATRIA,DIPUTADO NACIONAL,108,0,108,5.407839037308942
00944,14,UNION POR LA PATRIA,PRESIDENTE Y VICE,109,0,109,5.465931189462456
00944,14,UNION POR LA PATRIA,SENADOR NACIONAL,108,0,108,5.407839037308942
00944,19,JUNTOS POR EL CAMBIO,DIPUTADO NACIONAL,0,92,92,4.478364602852723
00944,19,JUNTOS POR EL CAMBIO,PRESIDENTE Y VICE,0,93,93,4.5364567550062365
00944,19,JUNTOS POR EL CAMBIO,SENADOR NACIONAL,0,92,92,4.478364602852723
00944,19,UNION POR LA PATRIA,DIPUTADO NACIONAL,0,75,75,3.49079801624299
00944,19,UNION POR LA PATRIA,PRESIDENTE Y VICE,0,79,79,3.7231666248570447
00944,19,UNION POR LA PATRIA,SENADOR NACIONAL,0,76,76,3.548890168396504
00980,5,JUNTOS POR EL CAMBIO,DIPUTADO NACIONAL,106,0,106,5.291654733001915
00980,5,JUNTOS POR EL CAMBIO,PRESIDENTE Y VICE,107,0,107,5.349746885155429
00980,5,JUNTOS POR EL CAMBIO,SENADOR NACIONAL,106,0,106,5.291654733001915
00980,5,LA LIBERTAD AVANZA,PRESIDENTE Y VICE,69,0,69,3.142245103321908
00980,5,UNION POR LA PATRIA,DIPUTADO NACIONAL,73,0,73,3.3746137119359627
00980,5,UNION POR LA PATRIA,PRESIDENTE Y VICE,79,0,79,3.7231666248570447
00980,5,UNION POR LA PATRIA,SENADOR NACIONAL,75,0,75,3.49079801624299
00980,21,UNION POR LA PATRIA,SENADOR NACIONAL,80,0,80,3.781258777010559
00980,42,JUNTOS POR EL CAMBIO,DIPUTADO NACIONAL,0,77,77,3.6069823205500176
00980,42,JUNTOS POR EL CAMBIO,PRESIDENTE Y VICE,0,83,83,3.9555352334710996
00980,42,JUNTOS POR EL CAMBIO,SENADOR NACIONAL,0,76,76,3.548890168396504
00980,42,UNION POR LA PATRIA,DIPUTADO NACIONAL,0,73,73,3.3746137119359627
00980,42,UNION POR LA PATRIA,PRESIDENTE Y VICE,0,74,74,3.4327058640894763
00980,42,UNION POR LA PATRIA,SENADOR NACIONAL,0,73,73,3.3746137119359627
00980,64,JUNTOS POR EL CAMBIO,DIPUTADO NACIONAL,92,0,92,4.478364602852723
00980,64,JUNTOS POR EL CAMBIO,PRESIDENTE Y VICE,95,0,95,4.652641059313264
00980,64,JUNTOS POR EL CAMBIO,SENADOR NACIONAL,92,0,92,4.478364602852723
00980,64,LA LIBERTAD AVANZA,DIPUTADO NACIONAL,72,0,72,3.316521559782449
00980,64,LA LIBERTAD AVANZA,PRESIDENTE Y VICE,92,0,92,4.478364602852723
00980,64,LA LIBERTAD AVANZA,SENADOR NACIONAL,72,0,72,3.316521559782449
00980,64,UNION POR LA PATRIA,DIPUTADO NACIONAL,68,0,68,3.0841529511683943
00980,64,UNION POR LA PATRIA,PRESIDENTE Y VICE,79,0,79,3.7231666248570447
00980,64,UNION POR LA PATRIA,SENADOR NACIONAL,68,0,68,3.0841529511683943
01013,5,UNION POR LA PATRIA,DIPUTADO NACIONAL,96,0,96,4.710733211466778
01013,5,UNION POR LA PATRIA,PRESIDENTE Y VICE,113,0,113,5.69829979807651
01013,5,UNION POR LA PATRIA,SENADOR NACIONAL,99,0,99,4.885009667927319
01013,33,JUNTOS POR EL CAMBIO,DIPUTADO NACIONAL,81,0,81,3.8393509291640724
01013,33,JUNTOS POR EL CAMBIO,PRESIDENTE Y VICE,80,0,80,3.781258777010559
01013,33,JUNTOS POR EL CAMBIO,SENADOR NACIONAL,81,0,81,3.8393509291640724
01013,33,UNION POR LA PATRIA,DIPUTADO NACIONAL,90,0,90,4.362180298545695
01013,33,UNION POR LA PATRIA,PRESIDENTE Y VICE,94,0,94,4.5945489071597505
01013,33,UNION POR LA PATRIA,SENADOR NACIONAL,90,0,90,4.362180298545695
01013,48,JUNTOS POR EL CAMBIO,DIPUTADO NACIONAL,110,0,110,5.52402334161597
01013,48,JUNTOS POR EL CAMBIO,PRESIDENTE Y VICE,97,0,97,4.768825363620292
01013,48,JUNTOS POR EL CAMBIO,SENADOR NACIONAL,109,0,109,5.465931189462456
01013,48,LA LIBERTAD AVANZA,PRESIDENTE Y VICE,75,0,75,3.49079801624299
01013,48,UNION POR LA PATRIA,DIPUTADO NACIONAL,80,0,80,3.781258777010559
01013,48,UNION POR LA PATRIA,PRESIDENTE Y VICE,93,0,93,4.5364567550062365
01013,48,UNION POR LA PATRIA,SENADOR NACIONAL,89,0,89,4.304088146392182
01013,51,JUNTOS POR EL CAMBIO,DIPUTADO NACIONAL,92,0,92,4.478364602852723
01013,51,JUNTOS POR EL CAMBIO,PRESIDENTE Y VICE,85,0,85,4.071719537778127
01013,51,JUNTOS POR EL CAMBIO,SENADOR NACIONAL,92,0,92,4.478364602852723
01013,51,LA LIBERTAD AVANZA,PRESIDENTE Y VICE,72,0,72,3.316521559782449
01013,51,UNION POR LA PATRIA,DIPUTADO NACIONAL,73,0,73,3.3746137119359627
01013,51,UNION POR LA PATRIA,PRESIDENTE Y VICE,81,0,81,3.8393509291640724
01013,51,UNION POR LA PATRIA,SENADOR NACIONAL,74,0,74,3.4327058640894763
01014,54,UNION POR LA PATRIA,DIPUTADO NACIONAL,110,0,110,5.52402334161597
01014,54,UNION POR LA PATRIA,PRESIDENTE Y VICE,118,0,118,5.9887605588440795
01014,54,UNION POR LA PATRIA,SENADOR NACIONAL,110,0,110,5.52402334161597
01014,67,UNION POR LA PATRIA,DIPUTADO NACIONAL,124,39,85,4.071719537778127
01014,67,UNION POR LA PATRIA,SENADOR NACIONAL,126,39,87,4.187903842085155
01014,70,UNION POR LA PATRIA,DIPUTADO NACIONAL,113,31,82,3.897443081317586
01014,70,UNION POR LA PATRIA,SENADOR NACIONAL,112,31,81,3.8393509291640724
01014,71,UNION POR LA PATRIA,DIPUTADO NACIONAL,0,102,102,5.05928612438786
01014,71,UNION POR LA PATRIA,PRESIDENTE Y VICE,0,102,102,5.05928612438786
01014,71,UNION POR LA PATRIA,SENADOR NACIONAL,0,103,103,5.117378276541373
01014,75,UNION POR LA PATRIA,SENADOR NACIONAL,11,78,67,3.0260607990148807
01014,78,LA LIBERTAD AVANZA,PRESIDENTE Y VICE,70,0,70,3.2003372554754215
01014,78,UNION POR LA PATRIA,DIPUTADO NACIONAL,126,0,126,6.453497776072188
01014,78,UNION POR LA PATRIA,PRESIDENTE Y VICE,132,0,132,6.802050688993271
01014,78,UNION POR LA PATRIA,SENADOR NACIONAL,127,0,127,6.511589928225702
01014,83,UNION POR LA PATRIA,DIPUTADO NACIONAL,0,110,110,5.52402334161597
01014,83,UNION POR LA PATRIA,PRESIDENTE Y VICE,0,109,109,5.465931189462456
01014,83,UNION POR LA PATRIA,SENADOR NACIONAL,0,112,112,5.640207645922997
01014,89,LA LIBERTAD AVANZA,PRESIDENTE Y VICE,82,4,78,3.665074472703531
01014,96,UNION POR LA PATRIA,DIPUTADO NACIONAL,0,96,96,4.710733211466778
01014,96,UNION POR LA PATRIA,PRESIDENTE Y VICE,0,97,97,4.768825363620292
01014,96,UNION POR LA PATRIA,SENADOR NACIONAL,0,97,97,4.768825363620292
01014,97,LA LIBERTAD AVANZA,DIPUTADO NACIONAL,70,0,70,3.2003372554754215
01014,97,LA LIBERTAD AVANZA,PRESIDENTE Y VICE,78,0,78,3.665074472703531
01014,97,LA LIBERTAD AVANZA,SENADOR NACIONAL,70,0,70,3.2003372554754215
01014,97,UNION POR LA PATRIA,DIPUTADO NACIONAL,112,0,112,5.640207645922997
01014,97,UNION POR LA PATRIA,PRESIDENTE Y VICE,122,0,122,6.221129167458134
01014,97,UNION POR LA PATRIA,SENADOR NACIONAL,112,0,112,5.640207645922997
01014,100,UNION POR LA PATRIA,DIPUTADO NACIONAL,115,0,115,5.814484102383538
01014,100,UNION POR LA PATRIA,PRESIDENTE Y VICE,129,0,129,6.62777423253273
01014,100,UNION POR LA PATRIA,SENADOR NACIONAL,116,0,116,5.8725762545370515
01014,102,UNION POR LA PATRIA,PRESIDENTE Y VICE,123,56,67,3.0260607990148807
01014,109,LA LIBERTAD AVANZA,PRESIDENTE Y VICE,0,71,71,3.2584294076289355
01014,109,UNION POR LA PATRIA,DIPUTADO NACIONAL,0,77,77,3.6069823205500176
01014,109,UNION POR LA PATRIA,PRESIDENTE Y VICE,0,71,71,3.2584294076289355
01014,109,UNION POR LA PATRIA,SENADOR NACIONAL,0,77,77,3.6069823205500176
01014,111,UNION POR LA PATRIA,DIPUTADO NACIONAL,127,0,127,6.511589928225702
01014,114,LA LIBERTAD AVANZA,DIPUTADO NACIONAL,73,6,67,3.0260607990148807
01014,114,LA LIBERTAD AVANZA,SENADOR NACIONAL,73,6,67,3.0260607990148807
01014,130,UNION POR LA PATRIA,DIPUTADO NACIONAL,0,91,91,4.420272450699209
01014,130,UNION POR LA PATRIA,PRESIDENTE Y VICE,0,90,90,4.362180298545695
01014,130,UNION POR LA PATRIA,SENADOR NACIONAL,0,91,91,4.420272450699209
01014,131,UNION POR LA PATRIA,DIPUTADO NACIONAL,133,0,133,6.860142841146785
01014,131,UNION POR LA PATRIA,PRESIDENTE Y VICE,147,0,147,7.673432971295976
01014,131,UNION POR LA PATRIA,SENADOR NACIONAL,133,0,133,6.860142841146785
01015,147,UNION POR LA PATRIA,DIPUTADO NACIONAL,80,0,80,3.781258777010559
01015,147,UNION POR LA PATRIA,SENADOR NACIONAL,80,0,80,3.781258777010559
01015,148,JUNTOS POR EL CAMBIO,DIPUTADO NACIONAL,80,0,80,3.781258777010559
01015,148,JUNTOS POR EL CAMBIO,PRESIDENTE Y VICE,73,0,73,3.3746137119359627
01015,148,JUNTOS POR EL CAMBIO,SENADOR NACIONAL,79,0,79,3.7231666248570447
01015,148,LA LIBERTAD AVANZA,DIPUTADO NACIONAL,80,0,80,3.781258777010559
01015,148,LA LIBERTAD AVANZA,PRESIDENTE Y VICE,87,0,87,4.187903842085155
01015,148,LA LIBERTAD AVANZA,SENADOR NACIONAL,80,0,80,3.781258777010559
01015,148,UNION POR LA PATRIA,DIPUTADO NACIONAL,78,0,78,3.665074472703531
01015,148,UNION POR LA PATRIA,PRESIDENTE Y VICE,78,0,78,3.665074472703531
01015,148,UNION POR LA PATRIA,SENADOR NACIONAL,79,0,79,3.7231666248570447
01016,160,JUNTOS POR EL CAMBIO,DIPUTADO NACIONAL,0,95,95,4.652641059313264
01016,160,JUNTOS POR EL CAMBIO,PRESIDENTE Y VICE,0,99,99,4.885009667927319
01016,160,JUNTOS POR EL CAMBIO,SENADOR NACIONAL,0,96,96,4.710733211466778
01016,160,UNION POR LA PATRIA,PRESIDENTE Y VICE,0,68,68,3.0841529511683943
01016,161,JUNTOS POR EL CAMBIO,DIPUTADO NACIONAL,85,0,85,4.071719537778127
01016,161,JUNTOS POR EL CAMBIO,PRESIDENTE Y VICE,87,0,87,4.187903842085155
01016,161,JUNTOS POR EL CAMBIO,SENADOR NACIONAL,85,0,85,4.071719537778127
01016,161,LA LIBERTAD AVANZA,DIPUTADO NACIONAL,74,0,74,3.4327058640894763
01016,161,LA LIBERTAD AVANZA,PRESIDENTE Y VICE,80,0,80,3.781258777010559
01016,161,LA LIBERTAD AVANZA,SENADOR NACIONAL,74,0,74,3.4327058640894763
01016,161,UNION POR LA PATRIA,DIPUTADO NACIONAL,86,0,86,4.129811689931641
01016,161,UNION POR LA PATRIA,PRESIDENTE Y VICE,94,0,94,4.5945489071597505
01016,161,UNION POR LA PATRIA,SENADOR NACIONAL,87,0,87,4.187903842085155
01017,176,UNION POR LA PATRIA,DIPUTADO NACIONAL,117,49,68,3.0841529511683943
01017,176,UNION POR LA PATRIA,SENADOR NACIONAL,117,48,69,3.142245103321908
01017,179,LA LIBERTAD AVANZA,DIPUTADO NACIONAL,70,0,70,3.2003372554754215
01017,179,LA LIBERTAD AVANZA,PRESIDENTE Y VICE,83,0,83,3.9555352334710996
01017,179,LA LIBERTAD AVANZA,SENADOR NACIONAL,70,0,70,3.2003372554754215
01017,179,UNION POR LA PATRIA,DIPUTADO NACIONAL,103,0,103,5.117378276541373
01017,179,UNION POR LA PATRIA,PRESIDENTE Y VICE,107,0,107,5.349746885155429
01017,179,UNION POR LA PATRIA,SENADOR NACIONAL,104,0,104,5.175470428694887
01017,187,UNION POR LA PATRIA,DIPUTADO NACIONAL,113,36,77,3.6069823205500176
01017,187,UNION POR LA PATRIA,SENADOR NACIONAL,113,36,77,3.6069823205500176
01017,194,LA LIBERTAD AVANZA,PRESIDENTE Y VICE,0,67,67,3.0260607990148807
01017,194,UNION POR LA PATRIA,DIPUTADO NACIONAL,0,90,90,4.362180298545695
01017,194,UNION POR LA PATRIA,PRESIDENTE Y VICE,0,95,95,4.652641059313264
01017,194,UNION POR LA PATRIA,SENADOR NACIONAL,0,92,92,4.478364602852723
01017,197,LA LIBERTAD AVANZA,PRESIDENTE Y VICE,69,0,69,3.142245103321908
01017,197,UNION POR LA PATRIA,DIPUTADO NACIONAL,111,0,111,5.582115493769483
01017,197,UNION POR LA PATRIA,PRESIDENTE Y VICE,126,0,126,6.453497776072188
01017,197,UNION POR LA PATRIA,SENADOR NACIONAL,113,0,113,5.69829979807651
01017,202,UNION POR LA PATRIA,DIPUTADO NACIONAL,93,16,77,3.6069823205500176
01017,202,UNION POR LA PATRIA,SENADOR NACIONAL,94,16,78,3.665074472703531
01017,207,UNION POR LA PATRIA,DIPUTADO NACIONAL,0,84,84,4.013627385624614
01017,207,UNION POR LA PATRIA,PRESIDENTE Y VICE,0,86,86,4.129811689931641
01017,207,UNION POR LA PATRIA,SENADOR NACIONAL,0,86,86,4.129811689931641
01017,214,UNION POR LA PATRIA,SENADOR NACIONAL,117,37,80,3.781258777010559
01017,219,LA LIBERTAD AVANZA,PRESIDENTE Y VICE,78,0,78,3.665074472703531
01017,219,UNION POR LA PATRIA,DIPUTADO NACIONAL,118,0,118,5.9887605588440795
01017,219,UNION POR LA PATRIA,PRESIDENTE Y VICE,123,0,123,6.279221319611648
01017,219,UNION POR LA PATRIA,SENADOR NACIONAL,118,0,118,5.9887605588440795
01017,224,UNION POR LA PATRIA,DIPUTADO NACIONAL,128,0,128,6.569682080379216
01017,224,UNION POR LA PATRIA,SENADOR NACIONAL,130,0,130,6.685866384686244
01017,228,JUNTOS POR EL CAMBIO,DIPUTADO NACIONAL,77,0,77,3.6069823205500176
01017,228,JUNTOS POR EL CAMBIO,PRESIDENTE Y VICE,79,0,79,3.7231666248570447
01017,228,JUNTOS POR EL CAMBIO,SENADOR NACIONAL,77,0,77,3.6069823205500176
01017,228,LA LIBERTAD AVANZA,PRESIDENTE Y VICE,67,0,67,3.0260607990148807
01017,228,UNION POR LA PATRIA,DIPUTADO NACIONAL,104,0,104,5.175470428694887
01017,228,UNION POR LA PATRIA,PRESIDENTE Y VICE,110,0,110,5.52402334161597
01017,228,UNION POR LA PATRIA,SENADOR NACIONAL,104,0,104,5.175470428694887
01018,242,JUNTOS POR EL CAMBIO,DIPUTADO NACIONAL,89,0,89,4.304088146392182
01018,242,JUNTOS POR EL CAMBIO,PRESIDENTE Y VICE,88,0,88,4.245995994238668
01018,242,JUNTOS POR EL CAMBIO,SENADOR NACIONAL,90,0,90,4.362180298545695
01018,242,LA LIBERTAD AVANZA,PRESIDENTE Y VICE,73,0,73,3.3746137119359627
01018,242,UNION POR LA PATRIA,DIPUTADO NACIONAL,97,0,97,4.768825363620292
01018,242,UNION POR LA PATRIA,PRESIDENTE Y VICE,104,0,104,5.175470428694887
01018,242,UNION POR LA PATRIA,SENADOR NACIONAL,97,0,97,4.768825363620292
01018,243,UNION POR LA PATRIA,PRESIDENTE Y VICE,14,85,71,3.2584294076289355
01018,254,JUNTOS POR EL CAMBIO,DIPUTADO NACIONAL,0,70,70,3.2003372554754215
01018,254,JUNTOS POR EL CAMBIO,PRESIDENTE Y VICE,0,76,76,3.548890168396504
01018,254,JUNTOS POR EL CAMBIO,SENADOR NACIONAL,0,71,71,3.2584294076289355
01018,254,LA LIBERTAD AVANZA,PRESIDENTE Y VICE,0,75,75,3.49079801624299
01018,254,UNION POR LA PATRIA,DIPUTADO NACIONAL,0,84,84,4.013627385624614
01018,254,UNION POR LA PATRIA,PRESIDENTE Y VICE,0,83,83,3.9555352334710996
01018,254,UNION POR LA PATRIA,SENADOR NACIONAL,0,84,84,4.013627385624614
01021,269,LA LIBERTAD AVANZA,DIPUTADO NACIONAL,70,0,70,3.2003372554754215
01021,269,LA LIBERTAD AVANZA,PRESIDENTE Y VICE,73,0,73,3.3746137119359627
01021,269,LA LIBERTAD AVANZA,SENADOR NACIONAL,70,0,70,3.2003372554754215
01021,269,UNION POR LA PATRIA,DIPUTADO NACIONAL,128,0,128,6.569682080379216
01021,269,UNION POR LA PATRIA,PRESIDENTE Y VICE,134,0,134,6.918234993300298
01021,269,UNION POR LA PATRIA,SENADOR NACIONAL,130,0,130,6.685866384686244
01021,270,UNION POR LA PATRIA,DIPUTADO NACIONAL,0,105,105,5.233562580848401
01021,270,UNION POR LA PATRIA,PRESIDENTE Y VICE,0,115,115,5.814484102383538
01021,270,UNION POR LA PATRIA,SENADOR NACIONAL,0,102,102,5.05928612438786
01021,276,UNION POR LA PATRIA,DIPUTADO NACIONAL,153,0,153,8.021985884217058
01021,276,UNION POR LA PATRIA,PRESIDENTE Y VICE,161,0,161,8.486723101445168
01021,276,UNION POR LA PATRIA,SENADOR NACIONAL,155,0,155,8.138170188524086
01021,277,UNION POR LA PATRIA,DIPUTADO NACIONAL,112,35,77,3.6069823205500176
01021,277,UNION POR LA PATRIA,SENADOR NACIONAL,115,35,80,3.781258777010559
01021,280,UNION POR LA PATRIA,DIPUTADO NACIONAL,115,0,115,5.814484102383538
01021,280,UNION POR LA PATRIA,PRESIDENTE Y VICE,122,0,122,6.221129167458134
01021,280,UNION POR LA PATRIA,SENADOR NACIONAL,116,0,116,5.8725762545370515
01021,284,LA LIBERTAD AVANZA,PRESIDENTE Y VICE,78,0,78,3.665074472703531
01021,284,UNION POR LA PATRIA,DIPUTADO NACIONAL,149,0,149,7.789617275603003
01021,284,UNION POR LA PATRIA,PRESIDENTE Y VICE,168,0,168,8.893368166519764
01021,284,UNION POR LA PATRIA,SENADOR NACIONAL,152,0,152,7.963893732063545
0496A,414,UNION POR LA PATRIA,DIPUTADO NACIONAL,147,0,147,7.673432971295976
0496A,414,UNION POR LA PATRIA,PRESIDENTE Y VICE,154,0,154,8.080078036370573
0496A,414,UNION POR LA PATRIA,SENADOR NACIONAL,147,0,147,7.673432971295976
0496A,415,LA LIBERTAD AVANZA,PRESIDENTE Y VICE,72,0,72,3.316521559782449
0496A,415,UNION POR LA PATRIA,DIPUTADO NACIONAL,140,0,140,7.2667879062213805
0496A,415,UNION POR LA PATRIA,PRESIDENTE Y VICE,146,0,146,7.615340819142463
0496A,415,UNION POR LA PATRIA,SENADOR NACIONAL,143,0,143,7.441064362681922
0496A,417,LA LIBERTAD AVANZA,DIPUTADO NACIONAL,74,0,74,3.4327058640894763
0496A,417,LA LIBERTAD AVANZA,PRESIDENTE Y VICE,77,0,77,3.6069823205500176
0496A,417,LA LIBERTAD AVANZA,SENADOR NACIONAL,74,0,74,3.4327058640894763
0496B,440,UNION POR LA PATRIA,DIPUTADO NACIONAL,188,61,127,6.511589928225702
0496B,440,UNION POR LA PATRIA,PRESIDENTE Y VICE,175,61,114,5.756391950230024
0496B,440,UNION POR LA PATRIA,SENADOR NACIONAL,188,63,125,6.395405623918675
0496B,441,UNION POR LA PATRIA,DIPUTADO NACIONAL,177,61,116,5.8725762545370515
0496B,441,UNION POR LA PATRIA,PRESIDENTE Y VICE,179,82,97,4.768825363620292
0496B,441,UNION POR LA PATRIA,SENADOR NACIONAL,177,64,113,5.69829979807651
0496B,446,UNION POR LA PATRIA,DIPUTADO NACIONAL,107,0,107,5.349746885155429
0496B,446,UNION POR LA PATRIA,PRESIDENTE Y VICE,113,0,113,5.69829979807651
0496B,446,UNION POR LA PATRIA,SENADOR NACIONAL,108,0,108,5.407839037308942
0496B,456,LA LIBERTAD AVANZA,DIPUTADO NACIONAL,73,0,73,3.3746137119359627
0496B,456,LA LIBERTAD AVANZA,PRESIDENTE Y VICE,77,0,77,3.6069823205500176
0496B,456,LA LIBERTAD AVANZA,SENADOR NACIONAL,73,0,73,3.3746137119359627
0496B,456,UNION POR LA PATRIA,DIPUTADO NACIONAL,114,0,114,5.756391950230024
0496B,456,UNION POR LA PATRIA,PRESIDENTE Y VICE,122,0,122,6.221129167458134
0496B,456,UNION POR LA PATRIA,SENADOR NACIONAL,114,0,114,5.756391950230024
0496B,458,UNION POR LA PATRIA,PRESIDENTE Y VICE,116,46,70,3.2003372554754215
0496B,464,JUNTOS POR EL CAMBIO,DIPUTADO NACIONAL,68,0,68,3.0841529511683943
0496B,464,JUNTOS POR EL CAMBIO,SENADOR NACIONAL,68,0,68,3.0841529511683943
0496B,464,LA LIBERTAD AVANZA,DIPUTADO NACIONAL,72,0,72,3.316521559782449
0496B,464,LA LIBERTAD AVANZA,PRESIDENTE Y VICE,76,0,76,3.548890168396504
0496B,464,LA LIBERTAD AVANZA,SENADOR NACIONAL,72,0,72,3.316521559782449
0496B,464,UNION POR LA PATRIA,DIPUTADO NACIONAL,95,0,95,4.652641059313264
0496B,464,UNION POR LA PATRIA,PRESIDENTE Y VICE,100,0,100,4.943101820080833
0496B,464,UNION POR LA PATRIA,SENADOR NACIONAL,95,0,95,4.652641059313264
0496B,465,UNION POR LA PATRIA,DIPUTADO NACIONAL,81,0,81,3.8393509291640724
0496B,465,UNION POR LA PATRIA,PRESIDENTE Y VICE,88,0,88,4.245995994238668
0496B,465,UNION POR LA PATRIA,SENADOR NACIONAL,82,0,82,3.897443081317586
0496C,491,UNION POR LA PATRIA,DIPUTADO NACIONAL,129,60,69,3.142245103321908
0496C,491,UNION POR LA PATRIA,SENADOR NACIONAL,131,60,71,3.2584294076289355
0496C,497,JUNTOS POR EL CAMBIO,DIPUTADO NACIONAL,75,0,75,3.49079801624299
0496C,497,JUNTOS POR EL CAMBIO,PRESIDENTE Y VICE,75,0,75,3.49079801624299
0496C,497,JUNTOS POR EL CAMBIO,SENADOR NACIONAL,75,0,75,3.49079801624299
0496C,497,UNION POR LA PATRIA,DIPUTADO NACIONAL,113,0,113,5.69829979807651
0496C,497,UNION POR LA PATRIA,PRESIDENTE Y VICE,114,0,114,5.756391950230024
0496C,497,UNION POR LA PATRIA,SENADOR NACIONAL,112,0,112,5.640207645922997
0496D,519,UNION POR LA PATRIA,PRESIDENTE Y VICE,109,42,67,3.0260607990148807
0496D,522,LA LIBERTAD AVANZA,DIPUTADO NACIONAL,69,0,69,3.142245103321908
0496D,522,LA LIBERTAD AVANZA,PRESIDENTE Y VICE,81,0,81,3.8393509291640724
0496D,522,LA LIBERTAD AVANZA,SENADOR NACIONAL,70,0,70,3.2003372554754215
0496D,522,UNION POR LA PATRIA,DIPUTADO NACIONAL,110,0,110,5.52402334161597
0496D,522,UNION POR LA PATRIA,PRESIDENTE Y VICE,117,0,117,5.9306684066905655
0496D,522,UNION POR LA PATRIA,SENADOR NACIONAL,110,0,110,5.52402334161597
0496D,524,JUNTOS POR EL CAMBIO,PRESIDENTE Y VICE,67,0,67,3.0260607990148807
0496D,524,UNION POR LA PATRIA,DIPUTADO NACIONAL,121,0,121,6.16303701530462
0496D,524,UNION POR LA PATRIA,PRESIDENTE Y VICE,120,0,120,6.104944863151107
0496D,524,UNION POR LA PATRIA,SENADOR NACIONAL,121,0,121,6.16303701530462
0496D,532,LA LIBERTAD AVANZA,DIPUTADO NACIONAL,69,1,68,3.0841529511683943
0496D,532,UNION POR LA PATRIA,SENADOR NACIONAL,138,64,74,3.4327058640894763
0496D,539,JUNTOS POR EL CAMBIO,DIPUTADO NACIONAL,72,0,72,3.316521559782449
0496D,539,JUNTOS POR EL CAMBIO,PRESIDENTE Y VICE,72,0,72,3.316521559782449
0496D,539,JUNTOS POR EL CAMBIO,SENADOR NACIONAL,72,0,72,3.316521559782449
0496D,539,LA LIBERTAD AVANZA,DIPUTADO NACIONAL,72,0,72,3.316521559782449
0496D,539,LA LIBERTAD AVANZA,PRESIDENTE Y VICE,75,0,75,3.49079801624299
0496D,539,LA LIBERTAD AVANZA,SENADOR NACIONAL,72,0,72,3.316521559782449
0496D,539,UNION POR LA PATRIA,DIPUTADO NACIONAL,109,0,109,5.465931189462456
0496D,539,UNION POR LA PATRIA,PRESIDENTE Y VICE,111,0,111,5.582115493769483
0496D,539,UNION POR LA PATRIA,SENADOR NACIONAL,111,0,111,5.582115493769483
0496D,558,LA LIBERTAD AVANZA,DIPUTADO NACIONAL,74,0,74,3.4327058640894763
0496D,558,LA LIBERTAD AVANZA,PRESIDENTE Y VICE,72,0,72,3.316521559782449
0496D,558,LA LIBERTAD AVANZA,SENADOR NACIONAL,74,0,74,3.4327058640894763
0496D,558,UNION POR LA PATRIA,DIPUTADO NACIONAL,92,0,92,4.478364602852723
0496D,558,UNION POR LA PATRIA,PRESIDENTE Y VICE,101,0,101,5.001193972234346
0496D,558,UNION POR LA PATRIA,SENADOR NACIONAL,93,0,93,4.5364567550062365
0496D,560,JUNTOS POR EL CAMBIO,DIPUTADO NACIONAL,69,0,69,3.142245103321908
0496D,560,JUNTOS POR EL CAMBIO,PRESIDENTE Y VICE,71,0,71,3.2584294076289355
0496D,560,JUNTOS POR EL CAMBIO,SENADOR NACIONAL,68,0,68,3.0841529511683943
0496D,560,LA LIBERTAD AVANZA,DIPUTADO NACIONAL,67,0,67,3.0260607990148807
0496D,560,LA LIBERTAD AVANZA,PRESIDENTE Y VICE,70,0,70,3.2003372554754215
0496D,560,LA LIBERTAD AVANZA,SENADOR NACIONAL,67,0,67,3.0260607990148807
0496D,560,UNION POR LA PATRIA,DIPUTADO NACIONAL,108,0,108,5.407839037308942
0496D,560,UNION POR LA PATRIA,PRESIDENTE Y VICE,111,0,111,5.582115493769483
0496D,560,UNION POR LA PATRIA,SENADOR NACIONAL,109,0,109,5.465931189462456
0496D,563,LA LIBERTAD AVANZA,DIPUTADO NACIONAL,78,0,78,3.665074472703531
0496D,563,LA LIBERTAD AVANZA,PRESIDENTE Y VICE,81,0,81,3.8393509291640724
0496D,563,LA LIBERTAD AVANZA,SENADOR NACIONAL,78,0,78,3.665074472703531
0496D,564,JUNTOS POR EL CAMBIO,DIPUTADO NACIONAL,0,74,74,3.4327058640894763
0496D,564,JUNTOS POR EL CAMBIO,PRESIDENTE Y VICE,0,74,74,3.4327058640894763
0496D,564,JUNTOS POR EL CAMBIO,SENADOR NACIONAL,0,72,72,3.316521559782449
0496D,564,UNION POR LA PATRIA,DIPUTADO NACIONAL,0,90,90,4.362180298545695
0496D,564,UNION POR LA PATRIA,PRESIDENTE Y VICE,0,92,92,4.478364602852723
0496D,564,UNION POR LA PATRIA,SENADOR NACIONAL,0,90,90,4.362180298545695
0496D,566,UNION POR LA PATRIA,DIPUTADO NACIONAL,0,97,97,4.768825363620292
0496D,566,UNION POR LA PATRIA,PRESIDENTE Y VICE,0,95,95,4.652641059313264
0496D,566,UNION POR LA PATRIA,SENADOR NACIONAL,0,98,98,4.826917515773805
0497B,635,UNION POR LA PATRIA,DIPUTADO NACIONAL,111,37,74,3.4327058640894763
0497B,640,LA LIBERTAD AVANZA,DIPUTADO NACIONAL,72,0,72,3.316521559782449
0497B,640,LA LIBERTAD AVANZA,PRESIDENTE Y VICE,76,0,76,3.548890168396504
0497B,640,LA LIBERTAD AVANZA,SENADOR NACIONAL,72,0,72,3.316521559782449
0497B,640,UNION POR LA PATRIA,DIPUTADO NACIONAL,97,0,97,4.768825363620292
0497B,640,UNION POR LA PATRIA,PRESIDENTE Y VICE,102,0,102,5.05928612438786
0497B,640,UNION POR LA PATRIA,SENADOR NACIONAL,97,0,97,4.768825363620292
0497B,650,UNION POR LA PATRIA,PRESIDENTE Y VICE,124,53,71,3.2584294076289355
0497C,658,LA LIBERTAD AVANZA,DIPUTADO NACIONAL,94,0,94,4.5945489071597505
0497C,658,LA LIBERTAD AVANZA,PRESIDENTE Y VICE,99,0,99,4.885009667927319
0497C,658,LA LIBERTAD AVANZA,SENADOR NACIONAL,94,0,94,4.5945489071597505
0497C,658,UNION POR LA PATRIA,DIPUTADO NACIONAL,99,0,99,4.885009667927319
0497C,658,UNION POR LA PATRIA,PRESIDENTE Y VICE,102,0,102,5.05928612438786
0497C,658,UNION POR LA PATRIA,SENADOR NACIONAL,101,0,101,5.001193972234346
0497C,666,UNION POR LA PATRIA,PRESIDENTE Y VICE,130,62,68,3.0841529511683943
0497C,669,UNION POR LA PATRIA,DIPUTADO NACIONAL,0,73,73,3.3746137119359627
0497C,669,UNION POR LA PATRIA,PRESIDENTE Y VICE,0,73,73,3.3746137119359627
0497C,669,UNION POR LA PATRIA,SENADOR NACIONAL,0,73,73,3.3746137119359627
0497C,671,UNION POR LA PATRIA,DIPUTADO NACIONAL,108,0,108,5.407839037308942
0497C,671,UNION POR LA PATRIA,PRESIDENTE Y VICE,116,0,116,5.8725762545370515
0497C,671,UNION POR LA PATRIA,SENADOR NACIONAL,110,0,110,5.52402334161597
0497C,676,LA LIBERTAD AVANZA,PRESIDENTE Y VICE,74,2,72,3.316521559782449
0497C,679,UNION POR LA PATRIA,PRESIDENTE Y VICE,128,60,68,3.0841529511683943
0497E,727,UNION POR LA PATRIA,DIPUTADO NACIONAL,0,89,89,4.304088146392182
0497E,727,UNION POR LA PATRIA,PRESIDENTE Y VICE,0,94,94,4.5945489071597505
0497E,727,UNION POR LA PATRIA,SENADOR NACIONAL,0,89,89,4.304088146392182
0497E,749,LA LIBERTAD AVANZA,DIPUTADO NACIONAL,91,0,91,4.420272450699209
0497E,749,LA LIBERTAD AVANZA,PRESIDENTE Y VICE,92,0,92,4.478364602852723
0497E,749,LA LIBERTAD AVANZA,SENADOR NACIONAL,92,0,92,4.478364602852723
0497E,749,UNION POR LA PATRIA,DIPUTADO NACIONAL,87,0,87,4.187903842085155
0497E,749,UNION POR LA PATRIA,PRESIDENTE Y VICE,93,0,93,4.5364567550062365
0497E,749,UNION POR LA PATRIA,SENADOR NACIONAL,90,0,90,4.362180298545695
0503A,1054,JUNTOS POR EL CAMBIO,DIPUTADO NACIONAL,0,87,87,4.187903842085155
0503A,1054,JUNTOS POR EL CAMBIO,PRESIDENTE Y VICE,0,89,89,4.304088146392182
0503A,1054,JUNTOS POR EL CAMBIO,SENADOR NACIONAL,0,86,86,4.129811689931641
0503A,1054,UNION POR LA PATRIA,DIPUTADO NACIONAL,0,78,78,3.665074472703531
0503A,1054,UNION POR LA PATRIA,PRESIDENTE Y VICE,0,87,87,4.187903842085155
0503A,1054,UNION POR LA PATRIA,SENADOR NACIONAL,0,80,80,3.781258777010559
0504A,1206,UNION POR LA PATRIA,DIPUTADO NACIONAL,88,0,88,4.245995994238668
0504A,1206,UNION POR LA PATRIA,SENADOR NACIONAL,91,0,91,4.420272450699209
0504A,1208,JUNTOS POR EL CAMBIO,DIPUTADO NACIONAL,106,0,106,5.291654733001915
0504A,1208,JUNTOS POR EL CAMBIO,PRESIDENTE Y VICE,101,0,101,5.001193972234346
0504A,1208,JUNTOS POR EL CAMBIO,SENADOR NACIONAL,105,0,105,5.233562580848401
0504A,1208,UNION POR LA PATRIA,DIPUTADO NACIONAL,98,0,98,4.826917515773805
0504A,1208,UNION POR LA PATRIA,PRESIDENTE Y VICE,117,0,117,5.9306684066905655
0504A,1208,UNION POR LA PATRIA,SENADOR NACIONAL,105,0,105,5.233562580848401
0504A,1236,UNION POR LA PATRIA,DIPUTADO NACIONAL,120,43,77,3.6069823205500176
0504A,1236,UNION POR LA PATRIA,SENADOR NACIONAL,124,43,81,3.8393509291640724
0505A,1298,UNION POR LA PATRIA,DIPUTADO NACIONAL,132,60,72,3.316521559782449
0505A,1298,UNION POR LA PATRIA,SENADOR NACIONAL,133,60,73,3.3746137119359627
0505A,1305,UNION POR LA PATRIA,PRESIDENTE Y VICE,148,81,67,3.0260607990148807
0505A,1306,UNION POR LA PATRIA,DIPUTADO NACIONAL,120,48,72,3.316521559782449
0505A,1306,UNION POR LA PATRIA,SENADOR NACIONAL,122,49,73,3.3746137119359627
0505A,1307,UNION POR LA PATRIA,SENADOR NACIONAL,140,59,81,3.8393509291640724
0505B,1339,UNION POR LA PATRIA,DIPUTADO NACIONAL,0,87,87,4.187903842085155
0505B,1339,UNION POR LA PATRIA,PRESIDENTE Y VICE,0,85,85,4.071719537778127
0505B,1339,UNION POR LA PATRIA,SENADOR NACIONAL,0,86,86,4.129811689931641
0508A,1381,UNION POR LA PATRIA,DIPUTADO NACIONAL,89,3,86,4.129811689931641
0508A,1383,JUNTOS POR EL CAMBIO,DIPUTADO NACIONAL,91,0,91,4.420272450699209
0508A,1383,JUNTOS POR EL CAMBIO,PRESIDENTE Y VICE,83,0,83,3.9555352334710996
0508A,1383,JUNTOS POR EL CAMBIO,SENADOR NACIONAL,92,0,92,4.478364602852723
0508A,1383,LA LIBERTAD AVANZA,DIPUTADO NACIONAL,67,0,67,3.0260607990148807
0508A,1383,LA LIBERTAD AVANZA,PRESIDENTE Y VICE,75,0,75,3.49079801624299
0508A,1383,LA LIBERTAD AVANZA,SENADOR NACIONAL,67,0,67,3.0260607990148807
0508A,1383,UNION POR LA PATRIA,DIPUTADO NACIONAL,101,0,101,5.001193972234346
0508A,1383,UNION POR LA PATRIA,PRESIDENTE Y VICE,109,0,109,5.465931189462456
0508A,1383,UNION POR LA PATRIA,SENADOR NACIONAL,102,0,102,5.05928612438786
0508A,1385,JUNTOS POR EL CAMBIO,DIPUTADO NACIONAL,0,96,96,4.710733211466778
0508A,1385,JUNTOS POR EL CAMBIO,PRESIDENTE Y VICE,0,97,97,4.768825363620292
0508A,1385,JUNTOS POR EL CAMBIO,SENADOR NACIONAL,0,95,95,4.652641059313264
0508A,1385,UNION POR LA PATRIA,DIPUTADO NACIONAL,0,68,68,3.0841529511683943
0508A,1385,UNION POR LA PATRIA,PRESIDENTE Y VICE,0,67,67,3.0260607990148807
0508A,1385,UNION POR LA PATRIA,SENADOR NACIONAL,0,68,68,3.0841529511683943
0508A,1402,JUNTOS POR EL CAMBIO,DIPUTADO NACIONAL,74,0,74,3.4327058640894763
0508A,1402,JUNTOS POR EL CAMBIO,PRESIDENTE Y VICE,73,0,73,3.3746137119359627
0508A,1402,JUNTOS POR EL CAMBIO,SENADOR NACIONAL,73,0,73,3.3746137119359627
0508A,1402,LA LIBERTAD AVANZA,PRESIDENTE Y VICE,69,0,69,3.142245103321908
0508A,1402,UNION POR LA PATRIA,DIPUTADO NACIONAL,112,0,112,5.640207645922997
0508A,1402,UNION POR LA PATRIA,PRESIDENTE Y VICE,121,0,121,6.16303701530462
0508A,1402,UNION POR LA PATRIA,SENADOR NACIONAL,113,0,113,5.69829979807651
0508A,1409,JUNTOS POR EL CAMBIO,DIPUTADO NACIONAL,69,0,69,3.142245103321908
0508A,1409,JUNTOS POR EL CAMBIO,PRESIDENTE Y VICE,69,0,69,3.142245103321908
0508A,1409,JUNTOS POR EL CAMBIO,SENADOR NACIONAL,70,0,70,3.2003372554754215
0508A,1409,LA LIBERTAD AVANZA,DIPUTADO NACIONAL,70,0,70,3.2003372554754215
0508A,1409,LA LIBERTAD AVANZA,PRESIDENTE Y VICE,72,0,72,3.316521559782449
0508A,1409,LA LIBERTAD AVANZA,SENADOR NACIONAL,70,0,70,3.2003372554754215
0508A,1409,UNION POR LA PATRIA,DIPUTADO NACIONAL,93,0,93,4.5364567550062365
0508A,1409,UNION POR LA PATRIA,PRESIDENTE Y VICE,97,0,97,4.768825363620292
0508A,1409,UNION POR LA PATRIA,SENADOR NACIONAL,94,0,94,4.5945489071597505
0508B,1423,LA LIBERTAD AVANZA,PRESIDENTE Y VICE,78,10,68,3.0841529511683943
0508B,1431,UNION POR LA PATRIA,DIPUTADO NACIONAL,134,0,134,6.918234993300298
0508B,1431,UNION POR LA PATRIA,PRESIDENTE Y VICE,138,0,138,7.150603601914353
0508B,1431,UNION POR LA PATRIA,SENADOR NACIONAL,134,0,134,6.918234993300298
0508B,1432,UNION POR LA PATRIA,DIPUTADO NACIONAL,120,0,120,6.104944863151107
0508B,1432,UNION POR LA PATRIA,PRESIDENTE Y VICE,115,0,115,5.814484102383538
0508B,1432,UNION POR LA PATRIA,SENADOR NACIONAL,120,0,120,6.104944863151107
0508B,1433,UNION POR LA PATRIA,DIPUTADO NACIONAL,116,0,116,5.8725762545370515
0508B,1433,UNION POR LA PATRIA,PRESIDENTE Y VICE,122,0,122,6.221129167458134
0508B,1433,UNION POR LA PATRIA,SENADOR NACIONAL,117,0,117,5.9306684066905655
0508B,1434,LA LIBERTAD AVANZA,DIPUTADO NACIONAL,83,0,83,3.9555352334710996
0508B,1434,LA LIBERTAD AVANZA,PRESIDENTE Y VICE,88,0,88,4.245995994238668
0508B,1434,LA LIBERTAD AVANZA,SENADOR NACIONAL,83,0,83,3.9555352334710996
0508B,1434,UNION POR LA PATRIA,DIPUTADO NACIONAL,131,0,131,6.743958536839757
0508B,1434,UNION POR LA PATRIA,PRESIDENTE Y VICE,132,0,132,6.802050688993271
0508B,1434,UNION POR LA PATRIA,SENADOR NACIONAL,132,0,132,6.802050688993271
0508C,1436,LA LIBERTAD AVANZA,DIPUTADO NACIONAL,77,0,77,3.6069823205500176
0508C,1436,LA LIBERTAD AVANZA,PRESIDENTE Y VICE,82,0,82,3.897443081317586
0508C,1436,LA LIBERTAD AVANZA,SENADOR NACIONAL,77,0,77,3.6069823205500176
0508C,1436,UNION POR LA PATRIA,DIPUTADO NACIONAL,113,0,113,5.69829979807651
0508C,1436,UNION POR LA PATRIA,PRESIDENTE Y VICE,122,0,122,6.221129167458134
0508C,1436,UNION POR LA PATRIA,SENADOR NACIONAL,113,0,113,5.69829979807651
0508C,1443,UNION POR LA PATRIA,SENADOR NACIONAL,128,61,67,3.0260607990148807
0508C,1454,LA LIBERTAD AVANZA,DIPUTADO NACIONAL,76,0,76,3.548890168396504
0508C,1454,LA LIBERTAD AVANZA,PRESIDENTE Y VICE,84,0,84,4.013627385624614
0508C,1454,LA LIBERTAD AVANZA,SENADOR NACIONAL,76,0,76,3.548890168396504
0508C,1454,UNION POR LA PATRIA,DIPUTADO NACIONAL,126,0,126,6.453497776072188
0508C,1454,UNION POR LA PATRIA,PRESIDENTE Y VICE,136,0,136,7.034419297607326
0508C,1454,UNION POR LA PATRIA,SENADOR NACIONAL,127,0,127,6.511589928225702
0508C,1456,UNION POR LA PATRIA,PRESIDENTE Y VICE,137,62,75,3.49079801624299
0508C,1460,UNION POR LA PATRIA,DIPUTADO NACIONAL,101,0,101,5.001193972234346
0508C,1460,UNION POR LA PATRIA,PRESIDENTE Y VICE,107,14,93,4.5364567550062365
0508C,1460,UNION POR LA PATRIA,SENADOR NACIONAL,102,0,102,5.05928612438786
0508D,1483,LA LIBERTAD AVANZA,DIPUTADO NACIONAL,84,0,84,4.013627385624614
0508D,1483,LA LIBERTAD AVANZA,PRESIDENTE Y VICE,92,0,92,4.478364602852723
0508D,1483,LA LIBERTAD AVANZA,SENADOR NACIONAL,84,0,84,4.013627385624614
0508D,1483,UNION POR LA PATRIA,DIPUTADO NACIONAL,96,0,96,4.710733211466778
0508D,1483,UNION POR LA PATRIA,PRESIDENTE Y VICE,110,0,110,5.52402334161597
0508D,1483,UNION POR LA PATRIA,SENADOR NACIONAL,96,0,96,4.710733211466778
0508D,1489,JUNTOS POR EL CAMBIO,PRESIDENTE Y VICE,0,72,72,3.316521559782449
0508D,1489,UNION POR LA PATRIA,PRESIDENTE Y VICE,0,74,74,3.4327058640894763
0508D,1491,LA LIBERTAD AVANZA,DIPUTADO NACIONAL,80,0,80,3.781258777010559
0508D,1491,LA LIBERTAD AVANZA,PRESIDENTE Y VICE,83,0,83,3.9555352334710996
0508D,1491,LA LIBERTAD AVANZA,SENADOR NACIONAL,80,0,80,3.781258777010559
0508D,1491,UNION POR LA PATRIA,DIPUTADO NACIONAL,129,0,129,6.62777423253273
0508D,1491,UNION POR LA PATRIA,PRESIDENTE Y VICE,135,0,135,6.976327145453812
0508D,1491,UNION POR LA PATRIA,SENADOR NACIONAL,129,0,129,6.62777423253273
0508E,1502,UNION POR LA PATRIA,PRESIDENTE Y VICE,107,36,71,3.2584294076289355
0508E,1505,LA LIBERTAD AVANZA,DIPUTADO NACIONAL,84,0,84,4.013627385624614
0508E,1505,LA LIBERTAD AVANZA,PRESIDENTE Y VICE,86,0,86,4.129811689931641
0508E,1505,LA LIBERTAD AVANZA,SENADOR NACIONAL,84,0,84,4.013627385624614
0508E,1505,UNION POR LA PATRIA,DIPUTADO NACIONAL,110,0,110,5.52402334161597
0508E,1505,UNION POR LA PATRIA,PRESIDENTE Y VICE,116,0,116,5.8725762545370515
0508E,1505,UNION POR LA PATRIA,SENADOR NACIONAL,111,0,111,5.582115493769483
0508E,1507,LA LIBERTAD AVANZA,PRESIDENTE Y VICE,72,0,72,3.316521559782449
0508E,1507,UNION POR LA PATRIA,DIPUTADO NACIONAL,117,0,117,5.9306684066905655
0508E,1507,UNION POR LA PATRIA,PRESIDENTE Y VICE,112,0,112,5.640207645922997
0508E,1507,UNION POR LA PATRIA,SENADOR NACIONAL,117,0,117,5.9306684066905655
0508E,1514,LA LIBERTAD AVANZA,DIPUTADO NACIONAL,71,0,71,3.2584294076289355
0508E,1514,LA LIBERTAD AVANZA,PRESIDENTE Y VICE,79,0,79,3.7231666248570447
0508E,1514,LA LIBERTAD AVANZA,SENADOR NACIONAL,71,0,71,3.2584294076289355
0508E,1514,UNION POR LA PATRIA,DIPUTADO NACIONAL,98,0,98,4.826917515773805
0508E,1514,UNION POR LA PATRIA,PRESIDENTE Y VICE,108,0,108,5.407839037308942
0508E,1514,UNION POR LA PATRIA,SENADOR NACIONAL,99,0,99,4.885009667927319
0509A,1559,JUNTOS POR EL CAMBIO,DIPUTADO NACIONAL,69,0,69,3.142245103321908
0509A,1559,JUNTOS POR EL CAMBIO,PRESIDENTE Y VICE,69,0,69,3.142245103321908
0509A,1559,JUNTOS POR EL CAMBIO,SENADOR NACIONAL,69,0,69,3.142245103321908
0509A,1559,LA LIBERTAD AVANZA,DIPUTADO NACIONAL,97,0,97,4.768825363620292
0509A,1559,LA LIBERTAD AVANZA,PRESIDENTE Y VICE,100,0,100,4.943101820080833
0509A,1559,LA LIBERTAD AVANZA,SENADOR NACIONAL,97,0,97,4.768825363620292
0509A,1559,UNION POR LA PATRIA,DIPUTADO NACIONAL,91,0,91,4.420272450699209
0509A,1559,UNION POR LA PATRIA,PRESIDENTE Y VICE,95,0,95,4.652641059313264
0509A,1559,UNION POR LA PATRIA,SENADOR NACIONAL,93,0,93,4.5364567550062365
0509A,1565,JUNTOS POR EL CAMBIO,DIPUTADO NACIONAL,0,73,73,3.3746137119359627
0509A,1565,JUNTOS POR EL CAMBIO,PRESIDENTE Y VICE,0,75,75,3.49079801624299
0509A,1565,JUNTOS POR EL CAMBIO,SENADOR NACIONAL,0,72,72,3.316521559782449
0509A,1565,LA LIBERTAD AVANZA,DIPUTADO NACIONAL,0,84,84,4.013627385624614
0509A,1565,LA LIBERTAD AVANZA,PRESIDENTE Y VICE,0,88,88,4.245995994238668
0509A,1565,LA LIBERTAD AVANZA,SENADOR NACIONAL,0,84,84,4.013627385624614
0509A,1567,UNION POR LA PATRIA,DIPUTADO NACIONAL,84,11,73,3.3746137119359627
0509A,1567,UNION POR LA PATRIA,SENADOR NACIONAL,84,11,73,3.3746137119359627
0509A,1570,JUNTOS POR EL CAMBIO,DIPUTADO NACIONAL,77,0,77,3.6069823205500176
0509A,1570,JUNTOS POR EL CAMBIO,PRESIDENTE Y VICE,75,0,75,3.49079801624299
0509A,1570,JUNTOS POR EL CAMBIO,SENADOR NACIONAL,77,0,77,3.6069823205500176
0509A,1570,LA LIBERTAD AVANZA,DIPUTADO NACIONAL,94,0,94,4.5945489071597505
0509A,1570,LA LIBERTAD AVANZA,PRESIDENTE Y VICE,101,0,101,5.001193972234346
0509A,1570,LA LIBERTAD AVANZA,SENADOR NACIONAL,94,0,94,4.5945489071597505
0509A,1570,UNION POR LA PATRIA,DIPUTADO NACIONAL,84,0,84,4.013627385624614
0509A,1570,UNION POR LA PATRIA,PRESIDENTE Y VICE,90,0,90,4.362180298545695
0509A,1570,UNION POR LA PATRIA,SENADOR NACIONAL,90,0,90,4.362180298545695
0711C,120,JUNTOS POR EL CAMBIO,DIPUTADO NACIONAL,67,0,67,3.0260607990148807
0711C,120,JUNTOS POR EL CAMBIO,PRESIDENTE Y VICE,69,0,69,3.142245103321908
0711C,120,JUNTOS POR EL CAMBIO,SENADOR NACIONAL,67,0,67,3.0260607990148807
0711C,120,LA LIBERTAD AVANZA,DIPUTADO NACIONAL,85,0,85,4.071719537778127
0711C,120,LA LIBERTAD AVANZA,PRESIDENTE Y VICE,96,0,96,4.710733211466778
0711C,120,LA LIBERTAD AVANZA,SENADOR NACIONAL,85,0,85,4.071719537778127
0711C,120,UNION POR LA PATRIA,DIPUTADO NACIONAL,90,0,90,4.362180298545695
0711C,120,UNION POR LA PATRIA,PRESIDENTE Y VICE,94,0,94,4.5945489071597505
0711C,120,UNION POR LA PATRIA,SENADOR NACIONAL,93,0,93,4.5364567550062365
0711D,134,LA LIBERTAD AVANZA,DIPUTADO NACIONAL,86,0,86,4.129811689931641
0711D,134,LA LIBERTAD AVANZA,PRESIDENTE Y VICE,92,17,75,3.49079801624299
0711D,134,LA LIBERTAD AVANZA,SENADOR NACIONAL,86,0,86,4.129811689931641
0711D,171,LA LIBERTAD AVANZA,DIPUTADO NACIONAL,71,0,71,3.2584294076289355
0711D,171,LA LIBERTAD AVANZA,PRESIDENTE Y VICE,80,0,80,3.781258777010559
0711D,171,LA LIBERTAD AVANZA,SENADOR NACIONAL,72,0,72,3.316521559782449
0711D,171,UNION POR LA PATRIA,DIPUTADO NACIONAL,88,0,88,4.245995994238668
0711D,171,UNION POR LA PATRIA,PRESIDENTE Y VICE,95,0,95,4.652641059313264
0711D,171,UNION POR LA PATRIA,SENADOR NACIONAL,72,0,72,3.316521559782449
0711E,193,HACEMOS POR NUESTRO PAIS,PRESIDENTE Y VICE,80,8,72,3.316521559782449
0711E,196,LA LIBERTAD AVANZA,DIPUTADO NACIONAL,89,4,85,4.071719537778127
0711E,196,LA LIBERTAD AVANZA,PRESIDENTE Y VICE,102,5,97,4.768825363620292
0711E,196,LA LIBERTAD AVANZA,SENADOR NACIONAL,89,3,86,4.129811689931641
0711E,201,LA LIBERTAD AVANZA,DIPUTADO NACIONAL,67,0,67,3.0260607990148807
0711E,201,LA LIBERTAD AVANZA,PRESIDENTE Y VICE,73,0,73,3.3746137119359627
0711E,201,LA LIBERTAD AVANZA,SENADOR NACIONAL,69,0,69,3.142245103321908
0711E,201,UNION POR LA PATRIA,DIPUTADO NACIONAL,82,0,82,3.897443081317586
0711E,201,UNION POR LA PATRIA,PRESIDENTE Y VICE,89,0,89,4.304088146392182
0711E,201,UNION POR LA PATRIA,SENADOR NACIONAL,83,0,83,3.9555352334710996
0711E,203,JUNTOS POR EL CAMBIO,DIPUTADO NACIONAL,68,0,68,3.0841529511683943
0711E,203,JUNTOS POR EL CAMBIO,PRESIDENTE Y VICE,67,0,67,3.0260607990148807
0711E,203,JUNTOS POR EL CAMBIO,SENADOR NACIONAL,68,0,68,3.0841529511683943
0711E,203,LA LIBERTAD AVANZA,DIPUTADO NACIONAL,72,0,72,3.316521559782449
0711E,203,LA LIBERTAD AVANZA,PRESIDENTE Y VICE,75,0,75,3.49079801624299
0711E,203,LA LIBERTAD AVANZA,SENADOR NACIONAL,71,0,71,3.2584294076289355
0711E,203,UNION POR LA PATRIA,DIPUTADO NACIONAL,85,0,85,4.071719537778127
0711E,203,UNION POR LA PATRIA,PRESIDENTE Y VICE,87,0,87,4.187903842085155
0711E,203,UNION POR LA PATRIA,SENADOR NACIONAL,88,0,88,4.245995994238668
0711E,226,JUNTOS POR EL CAMBIO,DIPUTADO NACIONAL,70,0,70,3.2003372554754215
0711E,226,JUNTOS POR EL CAMBIO,PRESIDENTE Y VICE,67,0,67,3.0260607990148807
0711E,226,JUNTOS POR EL CAMBIO,SENADOR NACIONAL,71,0,71,3.2584294076289355
0711E,226,LA LIBERTAD AVANZA,DIPUTADO NACIONAL,73,0,73,3.3746137119359627
0711E,226,LA LIBERTAD AVANZA,PRESIDENTE Y VICE,81,0,81,3.8393509291640724
0711E,226,LA LIBERTAD AVANZA,SENADOR NACIONAL,74,0,74,3.4327058640894763
0711E,226,UNION POR LA PATRIA,DIPUTADO NACIONAL,92,0,92,4.478364602852723
0711E,226,UNION POR LA PATRIA,PRESIDENTE Y VICE,96,0,96,4.710733211466778
0711E,226,UNION POR LA PATRIA,SENADOR NACIONAL,93,0,93,4.5364567550062365
0748A,64,JUNTOS POR EL CAMBIO,DIPUTADO NACIONAL,0,83,83,3.9555352334710996
0748A,64,JUNTOS POR EL CAMBIO,PRESIDENTE Y VICE,0,84,84,4.013627385624614
0748A,64,JUNTOS POR EL CAMBIO,SENADOR NACIONAL,0,85,85,4.071719537778127
0748A,64,LA LIBERTAD AVANZA,DIPUTADO NACIONAL,0,76,76,3.548890168396504
0748A,64,LA LIBERTAD AVANZA,PRESIDENTE Y VICE,0,76,76,3.548890168396504
0748A,64,LA LIBERTAD AVANZA,SENADOR NACIONAL,0,76,76,3.548890168396504
0748A,68,JUNTOS POR EL CAMBIO,DIPUTADO NACIONAL,75,0,75,3.49079801624299
0748A,68,JUNTOS POR EL CAMBIO,PRESIDENTE Y VICE,75,0,75,3.49079801624299
0748A,68,JUNTOS POR EL CAMBIO,SENADOR NACIONAL,75,0,75,3.49079801624299
0748A,68,LA LIBERTAD AVANZA,DIPUTADO NACIONAL,84,0,84,4.013627385624614
0748A,68,LA LIBERTAD AVANZA,PRESIDENTE Y VICE,91,0,91,4.420272450699209
0748A,68,LA LIBERTAD AVANZA,SENADOR NACIONAL,84,0,84,4.013627385624614
0748A,68,UNION POR LA PATRIA,DIPUTADO NACIONAL,79,0,79,3.7231666248570447
0748A,68,UNION POR LA PATRIA,PRESIDENTE Y VICE,83,0,83,3.9555352334710996
0748A,68,UNION POR LA PATRIA,SENADOR NACIONAL,79,0,79,3.7231666248570447
0748A,81,JUNTOS POR EL CAMBIO,DIPUTADO NACIONAL,0,87,87,4.187903842085155
0748A,81,JUNTOS POR EL CAMBIO,PRESIDENTE Y VICE,0,77,77,3.6069823205500176
0748A,81,JUNTOS POR EL CAMBIO,SENADOR NACIONAL,0,86,86,4.129811689931641
0748A,81,LA LIBERTAD AVANZA,PRESIDENTE Y VICE,0,82,82,3.897443081317586
0748A,82,JUNTOS POR EL CAMBIO,DIPUTADO NACIONAL,0,86,86,4.129811689931641
0748A,82,JUNTOS POR EL CAMBIO,PRESIDENTE Y VICE,0,86,86,4.129811689931641
0748A,82,JUNTOS POR EL CAMBIO,SENADOR NACIONAL,0,86,86,4.129811689931641
0748A,82,LA LIBERTAD AVANZA,PRESIDENTE Y VICE,0,71,71,3.2584294076289355
0748A,96,JUNTOS POR EL CAMBIO,DIPUTADO NACIONAL,0,93,93,4.5364567550062365
0748A,96,JUNTOS POR EL CAMBIO,PRESIDENTE Y VICE,0,90,90,4.362180298545695
0748A,96,JUNTOS POR EL CAMBIO,SENADOR NACIONAL,0,93,93,4.5364567550062365
0748A,96,LA LIBERTAD AVANZA,PRESIDENTE Y VICE,0,69,69,3.142245103321908
0748B,101,JUNTOS POR EL CAMBIO,DIPUTADO NACIONAL,83,0,83,3.9555352334710996
0748B,101,JUNTOS POR EL CAMBIO,PRESIDENTE Y VICE,79,0,79,3.7231666248570447
0748B,101,JUNTOS POR EL CAMBIO,SENADOR NACIONAL,82,0,82,3.897443081317586
0748B,101,LA LIBERTAD AVANZA,DIPUTADO NACIONAL,71,0,71,3.2584294076289355
0748B,101,LA LIBERTAD AVANZA,PRESIDENTE Y VICE,82,0,82,3.897443081317586
0748B,101,LA LIBERTAD AVANZA,SENADOR NACIONAL,74,0,74,3.4327058640894763
0748B,101,UNION POR LA PATRIA,DIPUTADO NACIONAL,72,0,72,3.316521559782449
0748B,101,UNION POR LA PATRIA,PRESIDENTE Y VICE,78,0,78,3.665074472703531
0748B,101,UNION POR LA PATRIA,SENADOR NACIONAL,72,0,72,3.316521559782449
0748B,105,LA LIBERTAD AVANZA,PRESIDENTE Y VICE,91,13,78,3.665074472703531
0748B,110,JUNTOS POR EL CAMBIO,DIPUTADO NACIONAL,78,0,78,3.665074472703531
0748B,110,JUNTOS POR EL CAMBIO,PRESIDENTE Y VICE,76,0,76,3.548890168396504
0748B,110,JUNTOS POR EL CAMBIO,SENADOR NACIONAL,78,0,78,3.665074472703531
0748B,110,LA LIBERTAD AVANZA,DIPUTADO NACIONAL,69,0,69,3.142245103321908
0748B,110,LA LIBERTAD AVANZA,PRESIDENTE Y VICE,79,0,79,3.7231666248570447
0748B,110,LA LIBERTAD AVANZA,SENADOR NACIONAL,69,0,69,3.142245103321908
0748B,110,UNION POR LA PATRIA,DIPUTADO NACIONAL,75,0,75,3.49079801624299
0748B,110,UNION POR LA PATRIA,PRESIDENTE Y VICE,82,0,82,3.897443081317586
0748B,110,UNION POR LA PATRIA,SENADOR NACIONAL,75,0,75,3.49079801624299
0748B,124,JUNTOS POR EL CAMBIO,DIPUTADO NACIONAL,72,0,72,3.316521559782449
0748B,124,JUNTOS POR EL CAMBIO,PRESIDENTE Y VICE,73,0,73,3.3746137119359627
0748B,124,JUNTOS POR EL CAMBIO,SENADOR NACIONAL,72,0,72,3.316521559782449
0748B,124,LA LIBERTAD AVANZA,DIPUTADO NACIONAL,75,0,75,3.49079801624299
0748B,124,LA LIBERTAD AVANZA,PRESIDENTE Y VICE,80,0,80,3.781258777010559
0748B,124,LA LIBERTAD AVANZA,SENADOR NACIONAL,75,0,75,3.49079801624299
0748B,124,UNION POR LA PATRIA,DIPUTADO NACIONAL,82,0,82,3.897443081317586
0748B,124,UNION POR LA PATRIA,PRESIDENTE Y VICE,91,0,91,4.420272450699209
0748B,124,UNION POR LA PATRIA,SENADOR NACIONAL,81,0,81,3.8393509291640724
0748B,125,JUNTOS POR EL CAMBIO,DIPUTADO NACIONAL,86,0,86,4.129811689931641
0748B,125,JUNTOS POR EL CAMBIO,PRESIDENTE Y VICE,84,0,84,4.013627385624614
0748B,125,JUNTOS POR EL CAMBIO,SENADOR NACIONAL,86,0,86,4.129811689931641
0748B,125,LA LIBERTAD AVANZA,PRESIDENTE Y VICE,71,0,71,3.2584294076289355
0748B,125,UNION POR LA PATRIA,DIPUTADO NACIONAL,87,0,87,4.187903842085155
0748B,125,UNION POR LA PATRIA,PRESIDENTE Y VICE,81,0,81,3.8393509291640724
0748B,125,UNION POR LA PATRIA,SENADOR NACIONAL,87,0,87,4.187903842085155
0748B,136,LA LIBERTAD AVANZA,DIPUTADO NACIONAL,67,0,67,3.0260607990148807
0748B,136,LA LIBERTAD AVANZA,PRESIDENTE Y VICE,75,0,75,3.49079801624299
0748B,136,LA LIBERTAD AVANZA,SENADOR NACIONAL,67,0,67,3.0260607990148807
0748C,154,LA LIBERTAD AVANZA,DIPUTADO NACIONAL,70,0,70,3.2003372554754215
0748C,154,LA LIBERTAD AVANZA,PRESIDENTE Y VICE,76,0,76,3.548890168396504
0748C,154,LA LIBERTAD AVANZA,SENADOR NACIONAL,70,0,70,3.2003372554754215
0748C,154,UNION POR LA PATRIA,DIPUTADO NACIONAL,88,0,88,4.245995994238668
0748C,154,UNION POR LA PATRIA,PRESIDENTE Y VICE,98,0,98,4.826917515773805
0748C,154,UNION POR LA PATRIA,SENADOR NACIONAL,90,0,90,4.362180298545695
0748C,160,UNION POR LA PATRIA,PRESIDENTE Y VICE,106,23,83,3.9555352334710996
0748C,164,LA LIBERTAD AVANZA,DIPUTADO NACIONAL,80,1,79,3.7231666248570447
0748C,164,LA LIBERTAD AVANZA,PRESIDENTE Y VICE,87,1,86,4.129811689931641
0748C,164,LA LIBERTAD AVANZA,SENADOR NACIONAL,80,1,79,3.7231666248570447
0748C,169,JUNTOS POR EL CAMBIO,DIPUTADO NACIONAL,72,0,72,3.316521559782449
0748C,169,JUNTOS POR EL CAMBIO,SENADOR NACIONAL,72,0,72,3.316521559782449
0748C,169,LA LIBERTAD AVANZA,DIPUTADO NACIONAL,77,0,77,3.6069823205500176
0748C,169,LA LIBERTAD AVANZA,PRESIDENTE Y VICE,92,0,92,4.478364602852723
0748C,169,LA LIBERTAD AVANZA,SENADOR NACIONAL,77,0,77,3.6069823205500176
0748C,169,UNION POR LA PATRIA,DIPUTADO NACIONAL,70,0,70,3.2003372554754215
0748C,169,UNION POR LA PATRIA,PRESIDENTE Y VICE,82,0,82,3.897443081317586
0748C,169,UNION POR LA PATRIA,SENADOR NACIONAL,70,0,70,3.2003372554754215
0748C,176,JUNTOS POR EL CAMBIO,DIPUTADO NACIONAL,71,0,71,3.2584294076289355
0748C,176,JUNTOS POR EL CAMBIO,PRESIDENTE Y VICE,67,0,67,3.0260607990148807
0748C,176,JUNTOS POR EL CAMBIO,SENADOR NACIONAL,71,0,71,3.2584294076289355
0748C,176,LA LIBERTAD AVANZA,DIPUTADO NACIONAL,78,0,78,3.665074472703531
0748C,176,LA LIBERTAD AVANZA,PRESIDENTE Y VICE,88,0,88,4.245995994238668
0748C,176,LA LIBERTAD AVANZA,SENADOR NACIONAL,78,0,78,3.665074472703531
0748C,176,UNION POR LA PATRIA,DIPUTADO NACIONAL,79,0,79,3.7231666248570447
0748C,176,UNION POR LA PATRIA,PRESIDENTE Y VICE,95,0,95,4.652641059313264
0748C,176,UNION POR LA PATRIA,SENADOR NACIONAL,80,0,80,3.781258777010559
0748D,197,LA LIBERTAD AVANZA,DIPUTADO NACIONAL,83,0,83,3.9555352334710996
0748D,197,LA LIBERTAD AVANZA,PRESIDENTE Y VICE,94,0,94,4.5945489071597505
0748D,197,LA LIBERTAD AVANZA,SENADOR NACIONAL,83,0,83,3.9555352334710996
0748D,210,JUNTOS POR EL CAMBIO,DIPUTADO NACIONAL,29,106,77,3.6069823205500176
0748D,213,JUNTOS POR EL CAMBIO,DIPUTADO NACIONAL,88,0,88,4.245995994238668
0748D,213,JUNTOS POR EL CAMBIO,PRESIDENTE Y VICE,84,0,84,4.013627385624614
0748D,213,JUNTOS POR EL CAMBIO,SENADOR NACIONAL,88,0,88,4.245995994238668
0748D,213,LA LIBERTAD AVANZA,PRESIDENTE Y VICE,71,0,71,3.2584294076289355
0748D,213,UNION POR LA PATRIA,DIPUTADO NACIONAL,74,0,74,3.4327058640894763
0748D,213,UNION POR LA PATRIA,PRESIDENTE Y VICE,87,0,87,4.187903842085155
0748D,213,UNION POR LA PATRIA,SENADOR NACIONAL,75,0,75,3.49079801624299
0748D,214,JUNTOS POR EL CAMBIO,DIPUTADO NACIONAL,86,0,86,4.129811689931641
0748D,214,JUNTOS POR EL CAMBIO,PRESIDENTE Y VICE,89,0,89,4.304088146392182
0748D,214,JUNTOS POR EL CAMBIO,SENADOR NACIONAL,86,0,86,4.129811689931641
0748D,214,LA LIBERTAD AVANZA,DIPUTADO NACIONAL,71,0,71,3.2584294076289355
0748D,214,LA LIBERTAD AVANZA,PRESIDENTE Y VICE,80,0,80,3.781258777010559
0748D,214,LA LIBERTAD AVANZA,SENADOR NACIONAL,71,0,71,3.2584294076289355
0748D,214,UNION POR LA PATRIA,DIPUTADO NACIONAL,73,0,73,3.3746137119359627
0748D,214,UNION POR LA PATRIA,PRESIDENTE Y VICE,74,0,74,3.4327058640894763
0748D,214,UNION POR LA PATRIA,SENADOR NACIONAL,73,0,73,3.3746137119359627
0748D,228,UNION POR LA PATRIA,PRESIDENTE Y VICE,76,9,67,3.0260607990148807
0748D,231,UNION POR LA PATRIA,PRESIDENTE Y VICE,88,16,72,3.316521559782449
0901A,98,LA LIBERTAD AVANZA,PRESIDENTE Y VICE,80,0,80,3.781258777010559
0901A,98,UNION POR LA PATRIA,DIPUTADO NACIONAL,95,0,95,4.652641059313264
0901A,98,UNION POR LA PATRIA,PRESIDENTE Y VICE,108,0,108,5.407839037308942
0901A,98,UNION POR LA PATRIA,SENADOR NACIONAL,95,0,95,4.652641059313264
0901A,108,JUNTOS POR EL CAMBIO,DIPUTADO NACIONAL,74,0,74,3.4327058640894763
0901A,108,JUNTOS POR EL CAMBIO,PRESIDENTE Y VICE,75,0,75,3.49079801624299
0901A,108,JUNTOS POR EL CAMBIO,SENADOR NACIONAL,74,0,74,3.4327058640894763
0901A,112,LA LIBERTAD AVANZA,DIPUTADO NACIONAL,76,0,76,3.548890168396504
0901A,112,UNION POR LA PATRIA,DIPUTADO NACIONAL,101,0,101,5.001193972234346
0901A,117,UNION POR LA PATRIA,DIPUTADO NACIONAL,99,0,99,4.885009667927319
0901A,117,UNION POR LA PATRIA,PRESIDENTE Y VICE,117,0,117,5.9306684066905655
0901A,117,UNION POR LA PATRIA,SENADOR NACIONAL,101,0,101,5.001193972234346
0901A,122,UNION POR LA PATRIA,DIPUTADO NACIONAL,101,31,70,3.2003372554754215
0901A,122,UNION POR LA PATRIA,SENADOR NACIONAL,101,31,70,3.2003372554754215
0901A,124,UNION POR LA PATRIA,DIPUTADO NACIONAL,95,25,70,3.2003372554754215
0901A,124,UNION POR LA PATRIA,SENADOR NACIONAL,97,25,72,3.316521559782449
0901A,127,JUNTOS POR EL CAMBIO,DIPUTADO NACIONAL,0,69,69,3.142245103321908
0901A,127,JUNTOS POR EL CAMBIO,PRESIDENTE Y VICE,0,72,72,3.316521559782449
0901A,127,JUNTOS POR EL CAMBIO,SENADOR NACIONAL,0,70,70,3.2003372554754215
0901A,127,LA LIBERTAD AVANZA,PRESIDENTE Y VICE,0,72,72,3.316521559782449
0901A,127,UNION POR LA PATRIA,DIPUTADO NACIONAL,0,82,82,3.897443081317586
0901A,127,UNION POR LA PATRIA,PRESIDENTE Y VICE,0,82,82,3.897443081317586
0901A,127,UNION POR LA PATRIA,SENADOR NACIONAL,0,82,82,3.897443081317586
0901A,129,LA LIBERTAD AVANZA,PRESIDENTE Y VICE,0,71,71,3.2584294076289355
0901A,129,UNION POR LA PATRIA,DIPUTADO NACIONAL,0,84,84,4.013627385624614
0901A,129,UNION POR LA PATRIA,PRESIDENTE Y VICE,0,83,83,3.9555352334710996
0901B,136,JUNTOS POR EL CAMBIO,DIPUTADO NACIONAL,0,74,74,3.4327058640894763
0901B,136,JUNTOS POR EL CAMBIO,PRESIDENTE Y VICE,0,74,74,3.4327058640894763
0901B,136,JUNTOS POR EL CAMBIO,SENADOR NACIONAL,0,78,78,3.665074472703531
0901B,136,LA LIBERTAD AVANZA,PRESIDENTE Y VICE,0,79,79,3.7231666248570447
0901B,147,UNION POR LA PATRIA,DIPUTADO NACIONAL,72,0,72,3.316521559782449
0901B,147,UNION POR LA PATRIA,SENADOR NACIONAL,72,1,71,3.2584294076289355
0901B,183,FRENTE DE IZQUIERDA Y DE TRABAJADORES - UNIDAD,DIPUTADO NACIONAL,5,73,68,3.0841529511683943
0901B,183,FRENTE DE IZQUIERDA Y DE TRABAJADORES - UNIDAD,SENADOR NACIONAL,4,74,70,3.2003372554754215
0901B,183,LA LIBERTAD AVANZA,DIPUTADO NACIONAL,92,0,92,4.478364602852723
0901B,183,LA LIBERTAD AVANZA,PRESIDENTE Y VICE,100,0,100,4.943101820080833
0901B,183,LA LIBERTAD AVANZA,SENADOR NACIONAL,92,0,92,4.478364602852723
